1: 紅蓮華 | LiSA
強くなれる理由を知った 僕を連れて進め | ['強い', 'なれる', '理由', 'を', '知る', 'た', '僕', 'を', '連れる', 'て', '進める']
泥だらけの走馬灯に酔う こわばる心 | ['泥', 'だらけ', 'の', '走馬灯', 'に', '酔う', 'こわばる', '心']
震える手は掴みたいものがある それだけさ | ['震える', '手', 'は', '掴む', 'たい', 'もの', 'が', 'ある', 'それだけ', 'さ']
夜の匂いに (I'll spend all thirty nights) | ['夜', 'の', '匂い', 'に', '(', 'I', "'", 'l', 'l', 'spend', 'all', 'thirty', 'nights', ')']
空睨んでも (Staring into the sky) | ['空', '睨む', 'で', 'も', '(', 'Staring', 'into', 'the', 'sky', ')']
変わっていけるのは自分自身だけ それだけさ | ['変わる', 'て', 'いける', 'の', 'は', '自分', '自身', 'だけ', 'それだけ', 'さ']
強くなれる理由を知った 僕を連れて進め | ['強い', 'なれる', '理由', 'を', '知る', 'た', '僕', 'を', '連れる', 'て', '進める']
どうしたって！ | ['どう', 'する', 'た', 'って', '!']
消せない夢も 止まれない今も | ['消せる', 'ない', '夢', 'も', '止まれる', 'ない', '今', 'も']
誰かのために強くなれるなら | ['誰', 'か', 'の', 'ため', 'に', '強い', 'なれる', 'だ']
ありがとう 悲しみよ | ['ありがとう', '悲しみ', 'よ']

2: 夜に駆ける | YOASOBI
沈むように溶けてゆくように | ['沈む', 'よう', 'に', '溶ける', 'て', 'ゆく', 'よう', 'に']
二人だけの空が広がる夜に | ['二', '人', 'だけ', 'の', '空', 'が', '広がる', '夜', 'に']
「さよなら」だけだった | ['「', 'さよなら', '」', 'だけ', 'だ', 'た']
その一言で全てが分かった | ['その', '一言', 'で', '全て', 'が', '分かる', 'た']
日が沈み出した空と君の姿 | ['日', 'が', '沈む', '出す', 'た', '空', 'と', '君', 'の', '姿']
フェンス越しに重なっていた | ['フェンス', '越し', 'に', '重なる', 'て', 'いる', 'た']
初めて会った日から | ['初めて', '会う', 'た', '日', 'から']
僕の心の全てを奪った | ['僕', 'の', '心', 'の', '全て', 'を', '奪う', 'た']
どこか儚い空気を纏う君は | ['どこ', 'か', '儚い', '空気', 'を', '纏う', '君', 'は']
寂しい目をしてたんだ | ['寂しい', '目', 'を', 'する', 'てる', 'た', 'ん', 'だ']
いつだってチックタックと | ['いつ', 'だって', 'チック', 'タック', 'と']
鳴る世界で何度だってさ | ['鳴る', '世界', 'で', '何', '度', 'だって', 'さ']
触れる心無い言葉うるさい声に | ['触れる', '心無い', '言葉', 'うるさい', '声', 'に']
涙が零れそうでも | ['涙', 'が', '零れる', 'そう', 'だ', 'も']
ありきたりな喜びきっと二人なら見つけられる | ['ある', 'き', 'たり', 'な', '喜ぶ', 'きっと', '二', '人', 'だ', '見つける', 'られる']
騒がしい日々に笑えない君に | ['騒がしい', '日々', 'に', '笑える', 'ない', '君', 'に']
思い付く限り眩しい明日を | ['思い付く', '限り', '眩しい', '明日', 'を']
明けない夜に落ちてゆく前に | ['明ける', 'ない', '夜', 'に', '落ちる', 'て', 'ゆく', '前', 'に']

3: ハルカ | YOASOBI
思い出すのは 出会った日のこと | ['思い出す', 'の', 'は', '出会う', 'た', '日', 'の', 'こと']
誰の元にも 帰れない僕 | ['誰', 'の', '元', 'に', 'も', '帰れる', 'ない', '僕']
見つけ出してくれた 救い出してくれた | ['見つけ出す', 'て', 'くれる', 'た', '救い出す', 'て', 'くれる', 'た']
忘れることない 君の笑顔 | ['忘れる', 'こと', 'ない', '君', 'の', '笑顔']
暮らしの隙間 夜更けの祈り | ['暮らし', 'の', '隙間', '夜更け', 'の', '祈り']
いつでも君と共に 歩いてきた奇跡 | ['いつ', 'でも', '君', 'と共に', '歩く', 'て', 'くる', 'た', '奇跡']
辛いことも 嬉しいことも | ['辛い', 'こと', 'も', '嬉しい', 'こと', 'も']
分かち合える そんな日々を | ['分かつ', '合える', 'そんな', '日々', 'を']
振り返れば数え切れない | ['振り返る', 'ば', '数え切れる', 'ない']
思い出が溢れ出して来る | ['思い出', 'が', '溢れる', '出す', 'て', '来る']
誰にも見えないところで頑張ってる | ['誰', 'に', 'も', '見える', 'ない', 'ところ', 'で', '頑張る', 'てる']
君のそばに いられることそれだけで | ['君', 'の', 'そば', 'に', 'いる', 'られる', 'こと', 'それ', 'だけ', 'だ']

4: 群青 | YOASOBI
嗚呼いつもの様に | ['嗚呼', 'いつも', 'の', '様', 'に']
過ぎる日々にあくびが出る | ['過ぎる', '日々', 'に', 'あくび', 'が', '出る']
さんざめく夜越え今日も | ['さんざめく', '夜', '越える', '今日', 'も']
渋谷の街に朝が降る | ['渋谷', 'の', '街', 'に', '朝', 'が', '降る']
どこか虚しいような | ['どこ', 'か', '虚しい', 'よう', 'だ']
そんな気持ち | ['そんな', '気持ち']
つまらないな | ['つまらない', 'な']
でもそれでいい | ['でも', 'それ', 'だ', 'いい']
そんなもんさ | ['そんな', 'もん', 'さ']
これでいい | ['これ', 'だ', 'いい']
知らず知らず隠してた | ['知る', 'ぬ', '知る', 'ぬ', '隠す', 'てる', 'た']
本当の声を響かせてよほら | ['本当', 'の', '声', 'を', '響かせる', 'て', 'よ', 'ほら']
見ないフリしていても | ['見る', 'ない', 'フリ', 'する', 'て', 'いる', 'て', 'も']
確かにそこにある | ['確か', 'に', 'そこ', 'に', 'ある']
嗚呼 感じたままに描く | ['嗚呼', '感じる', 'た', 'まま', 'に', '描く']
自分で選んだその色で | ['自分', 'で', '選ぶ', 'だ', 'その', '色', 'で']
眠い空気纏う朝に | ['眠い', '空気', '纏う', '朝', 'に']
訪れた青い世界 | ['訪れる', 'た', '青い', '世界']
好きなものを好きだと言う | ['好き', 'だ', 'もの', 'を', '好き', 'だ', 'と', '言う']
怖くて仕方ないけど | ['怖い', 'て', '仕方', 'ない', 'けど']
本当の自分 | ['本当', 'の', '自分']
出会えた気がしたんだ | ['出会える', 'た', '気', 'が', 'する', 'た', 'ん', 'だ']
嗚呼 手を伸ばせば伸ばすほどに | ['嗚呼', '手', 'を', '伸ばす', 'ば', '伸ばす', 'ほど', 'に']

5: 優しい彗星 | YOASOBI
今、静かな夜の中で | ['今', '、', '静か', 'だ', '夜', 'の', '中', 'で']
無計画に車を走らせた | ['無計画', 'に', '車', 'を', '走る', 'せる', 'た']
左隣、あなたの | ['左', '隣', '、', 'あなた', 'の']
横顔を月が照らした | ['横顔', 'を', '月', 'が', '照らす', 'た']
ただ、思い出を探る様に | ['ただ', '、', '思い出', 'を', '探る', '様', 'に']
辿る様に言葉を繋ぎ合わせれば | ['辿る', '様', 'に', '言葉', 'を', '繋ぐ', '合わせる', 'ば']
どうしようもなく溢れてくる | ['どう', 'しよう', 'も', 'ない', '溢れる', 'て', 'くる']
日々の記憶 | ['日々', 'の', '記憶']
あなたのそばで生きると決めたその日から | ['あなた', 'の', 'そば', 'で', '生きる', 'と', '決める', 'た', 'その', '日', 'から']
少しずつ変わり始めた世界 | ['少し', 'ずつ', '変わる', '始める', 'た', '世界']
強く在るように弱さを隠すように | ['強い', '在る', 'よう', 'に', '弱い', 'さ', 'を', '隠す', 'よう', 'に']
演じてきた日々に | ['演じる', 'て', 'くる', 'た', '日々', 'に']
ある日突然現れたその眼差しが | ['ある', '日', '突然', '現れる', 'た', 'その', '眼差し', 'が']

6: ハルジオン | YOASOBI
過ぎてゆく時間の中 | ['過ぎる', 'て', 'ゆく', '時間', 'の', '中']
あなたを思い出す | ['あなた', 'を', '思い出す']
物憂げに眺める画面に映った二人 | ['物憂い', 'げ', 'に', '眺める', '画面', 'に', '映る', 'た', '二', '人']
笑っていた | ['笑う', 'て', 'いる', 'た']
知りたくないほど | ['知る', 'たい', 'ない', 'ほど']
知りすぎてくこと | ['知る', 'すぎる', 'て', 'く', 'こと']
ただ過ぎる日々に呑み込まれたの | ['ただ', '過ぎる', '日々', 'に', '呑み込む', 'れる', 'た', 'の']
それでもただもう一度だけ会いたくて | ['それでも', 'ただ', 'もう一度', 'だけ', '会う', 'たい', 'て']
あなたの言葉に頷き信じた私を | ['あなた', 'の', '言葉', 'に', '頷く', '信じる', 'た', '私', 'を']
一人置き去りに時間は過ぎる | ['一', '人', '置き去り', 'に', '時間', 'は', '過ぎる']
見えていたはずの | ['見える', 'て', 'いる', 'た', 'はず', 'の']
未来も指の隙間をすり抜けた | ['未来', 'も', '指', 'の', '隙間', 'を', 'すり抜ける', 'た']
戻れない日々の欠片と | ['戻れる', 'ない', '日々', 'の', '欠片', 'と']
あなたの気配を | ['あなた', 'の', '気配', 'を']
今でも探してしまうよ | ['今', 'でも', '探す', 'て', 'しまう', 'よ']
まだあの日の二人に手を伸ばしてる | ['まだ', 'あの', '日', 'の', '二', '人', 'に', '手', 'を', '伸ばす', 'てる']

7: 怪物 | YOASOBI
あぁ素晴らしき世界に今日も乾杯 | ['あぁ', '素晴らしい', '世界', 'に', '今日', 'も', '乾杯']
街に飛び交う笑い声も | ['街', 'に', '飛び交う', '笑い声', 'も']
見て見ぬフリしてるだけの作りもんさ | ['見る', 'て', '見る', 'ぬ', 'フリ', 'する', 'てる', 'だけ', 'の', '作り', 'もん', 'さ']
気が触れそうだ | ['気', 'が', '触れる', 'そう', 'だ']
クラクラするほどの良い匂いが | ['クラクラ', 'する', 'ほど', 'の', '良い', '匂い', 'が']
ツンと刺した鼻の奥 | ['ツン', 'と', '刺す', 'た', '鼻', 'の', '奥']
目を覚ます本能のまま | ['目', 'を', '覚ます', '本能', 'の', 'まま']
今日は誰の番だ？ | ['今日', 'は', '誰', 'の', '番', 'だ', '?']
この世界で何が出来るのか | ['この', '世界', 'で', '何', 'が', '出来る', 'の', 'か']
僕には何が出来るのか | ['僕', 'に', 'は', '何', 'が', '出来る', 'の', 'か']
ただその真っ黒な目から | ['ただ', 'その', '真っ黒', 'だ', '目', 'から']
涙溢れ落ちないように | ['涙', '溢れる', '落ちる', 'ない', 'よう', 'に']
あぁ願う未来に何度でもずっと | ['あぁ', '願う', '未来', 'に', '何', '度', 'でも', 'ずっと']
喰らいつく | ['喰らう', 'つく']
この間違いだらけの世界の中 | ['この', '間違い', 'だらけ', 'の', '世界', 'の', '中']
君には笑ってほしいから | ['君', 'に', 'は', '笑う', 'て', 'ほしい', 'から']
もう誰も傷付けない | ['もう', '誰', 'も', '傷付ける', 'ない']
強く強くなりたいんだよ | ['強い', '強い', 'なる', 'たい', 'ん', 'だ', 'よ']
僕が僕でいられるように | ['僕', 'が', '僕', 'で', 'いる', 'られる', 'よう', 'に']

8: あの夢をなぞって | YOASOBI
夜の空を飾る綺麗な花 | ['夜', 'の', '空', 'を', '飾る', '綺麗', 'だ', '花']
街の声をぎゅっと光が包み込む | ['街', 'の', '声', 'を', 'ぎゅっと', '光', 'が', '包み込む']
音の無い二人だけの世界で聞こえた言葉は | ['音', 'の', '無い', '二', '人', 'だけ', 'の', '世界', 'で', '聞こえる', 'た', '言葉', 'は']
「好きだよ」 | ['「', '好き', 'だ', 'よ', '」']
夢の中で見えた未来のこと | ['夢', 'の', '中', 'で', '見える', 'た', '未来', 'の', 'こと']
夏の夜、君と、並ぶ影が二つ | ['夏', 'の', '夜', '、', '君', 'と', '、', '並ぶ', '影', 'が', '二つ']
最後の花火が空に昇って消えたら | ['最後', 'の', '花火', 'が', '空', 'に', '昇る', 'て', '消える', 'た']
それを合図に | ['それ', 'を', '合図', 'に']
いつも通りの朝に | ['いつも', '通り', 'の', '朝', 'に']
いつも通りの君の姿 | ['いつも', '通り', 'の', '君', 'の', '姿']
思わず目を逸らしてしまったのは | ['思わず', '目', 'を', '逸らす', 'て', 'しまう', 'た', 'の', 'は']
どうやったって忘れられない君の言葉 | ['どう', 'やる', 'たって', '忘れる', 'られる', 'ない', '君', 'の', '言葉']
今もずっと響いてるから | ['今', 'も', 'ずっと', '響く', 'てる', 'から']
あぁ夜を抜けて夢の先へ | ['あぁ', '夜', 'を', '抜ける', 'て', '夢', 'の', '先', 'へ']
辿り着きたい未来へ | ['辿る', '着く', 'たい', '未来', 'へ']

9: 火炎 | QUEEN BEE
Party is over | ['Party', 'i', 's', 'over']
それでも踊りたかった | ['それでも', '踊る', 'たい', 'た']
眠れないくらい | ['眠れる', 'ない', 'くらい']
情熱の火はいつしか | ['情熱', 'の', '火', 'は', 'いつしか']
いつの日にか | ['いつ', 'の', '日', 'に', 'か']
はなから気付いている 焔はいつか消える | ['はな', 'から', '気付く', 'て', 'いる', '焔', 'は', 'いつか', '消える']
ねぇ なにも要らないはずだった | ['ねぇ', 'なに', 'も', '要る', 'ない', 'はず', 'だ', 'た']
なのにまだ I'm so serious | ['なのに', 'まだ', 'I', "'", 'm', 's', 'o', 'serious']
ああまだ間に合う ああただBurn it up | ['ああ', 'まだ', '間に合う', 'ああ', 'ただ', 'Burn', 'i', 't', 'u', 'p']
Baby Sorry darling そんなに甘くないよ | ['Baby', 'Sorry', 'darling', 'そんなに', '甘い', 'ない', 'よ']
でもきっとそんなに悪くないよ | ['でも', 'きっと', 'そんなに', '悪い', 'ない', 'よ']
Give me fire | ['Give', 'm', 'e', 'fire']
Light it up, Baby 燃やしちゃうぜ yeah | ['Light', 'i', 't', 'up', ',', 'Baby', '燃やす', 'ちゃう', 'ぜ', 'yeah']
(燃えろよ 燃えろよ 炎よ 燃えろ) | ['(', '燃える', 'よ', '燃える', 'よ', '炎', 'よ', '燃える', ')']

None type
11: Shinzo wo Sasageyo ! | Linked Horizon
これ以上の地獄はないだろうと信じたかった | ['これ', '以上', 'の', '地獄', 'は', 'ない', 'だ', 'う', 'と', '信じる', 'たい', 'た']
されど人類最悪の日はいつも唐突に... | ['されど', '人類', '最悪', 'の', '日', 'は', 'いつも', '唐突', 'に', '.', '.', '.']
扉を叩く音は絶えず 酷く無作法で | ['扉', 'を', '叩く', '音', 'は', '絶えず', '酷い', '無作法', 'だ']
招かれた最悪の日は悪夢のように... | ['招く', 'れる', 'た', '最悪', 'の', '日', 'は', '悪夢', 'の', 'よう', 'に', '.', '.', '.']

12: from the edge -TV ver.- | FictionJunction
悲しみに 囚われたくはない | ['悲しみ', 'に', '囚われる', 'たい', 'は', 'ない']
俯いた場所に 涙を落として行きたくない | ['俯く', 'た', '場所', 'に', '涙', 'を', '落とす', 'て', '行く', 'たい', 'ない']
運命を振り解いて | ['運命', 'を', '振る', '解く', 'て']
走り出せるはずなんだ | ['走り出せる', 'はず', 'だ', 'ん', 'だ']
願いは叶うはずなんだ | ['願い', 'は', '叶う', 'はず', 'だ', 'ん', 'だ']

13: Black Catcher | VK Blanka
風が背中を張って | ['風', 'が', '背中', 'を', '張る', 'て']
滴は糸を伝って | ['滴', 'は', '糸', 'を', '伝う', 'て']
Get Up 目を覚ましてよ | ['Get', 'U', 'p', '目', 'を', '覚ます', 'て', 'よ']
Get Down もうまもなく | ['Get', 'Down', 'もう', 'まもなく']
願いを文字に起こして 血潮に乗って | ['願い', 'を', '文字', 'に', '起こす', 'て', '血潮', 'に', '乗る', 'て']
その身に纏った黒 | ['その', '身', 'に', '纏う', 'た', '黒']
曇りなく全てを振り払うように | ['曇る', 'ない', '全て', 'を', '振り払う', 'よう', 'に']
サイレンは裏腹のSOS | ['サイレン', 'は', '裏腹', 'の', 'SOS']
早く手遅れですよ | ['早い', '手遅れ', 'です', 'よ']
近づかなかきゃ見えない絆なんて | ['近づく', 'ない', 'かく', '見える', 'ない', '絆', 'なんて']
あってなくて | ['ある', 'て', 'ない', 'て']
僕らいま旅の途中 | ['僕ら', 'いま', '旅', 'の', '途中']
どうしていま疼く鈍痛 | ['どうして', 'いま', '疼く', '鈍痛']
Somebody just help me out | ['Somebody', 'just', 'help', 'm', 'e', 'out']
叶えよう約束通り | ['叶える', 'う', '約束', '通り']
ひび割れた世界で | ['ひび割れる', 'た', '世界', 'で']

14: crossing field | LiSA
認めていた臆病な過去 | ['認める', 'て', 'いる', 'た', '臆病', 'だ', '過去']
わからないままに怖がっていた | ['わかる', 'ない', 'まま', 'に', '怖がる', 'て', 'いる', 'た']
後ろの自分が現実を今に映す | ['後ろ', 'の', '自分', 'が', '現実', 'を', '今', 'に', '映す']
いくつもの空を描いたここはきっと | ['いくつ', 'も', 'の', '空', 'を', '描く', 'た', 'ここ', 'は', 'きっと']
儚い心 乱して | ['儚い', '心', '乱す', 'て']
夢で高く跳んだ躰は | ['夢', 'で', '高い', '跳ぶ', 'だ', '躰', 'は']
どんな不安纏っても振り払っていく | ['どんな', '不安', '纏う', 'て', 'も', '振り払う', 'て', 'いく']
眠る小さな想い拡がり出して | ['眠る', '小さな', '想い', '拡がる', '出す', 'て']
気付く弱い私 君がいれば | ['気付く', '弱い', '私', '君', 'が', 'いる', 'ば']
暗い世界強くいれた | ['暗い', '世界', '強い', 'いれる', 'た']
長い夢見る心はそう永遠で | ['長い', '夢見る', '心', 'は', 'そう', '永遠', 'で']
I wanna always be with you | ['I', 'wanna', 'always', 'b', 'e', 'with', 'you']

15: Guren No Yumiya | Linked Horizon
その日、人類は思い出した | ['その', '日', '、', '人類', 'は', '思い出す', 'た']
奴らに支配されていた恐怖を | ['奴ら', 'に', '支配', 'する', 'れる', 'て', 'いる', 'た', '恐怖', 'を']
鳥かごの中に囚われていた、屈辱を | ['鳥かご', 'の', '中', 'に', '囚われる', 'て', 'いる', 'た', '、', '屈辱', 'を']
放たれた弓矢よ、壁を越え海まで飛んで行け！ | ['放つ', 'れる', 'た', '弓矢', 'よ', '、', '壁', 'を', '越える', '海', 'まで', '飛ぶ', 'で', '行く', '!']
Feuerroter pfeil und bogen | ['Feuerroter', 'pfeil', 'und', 'bogen']
踏まれた花の 名前も知らずに | ['踏む', 'れる', 'た', '花', 'の', '名前', 'も', '知る', 'ぬ', 'に']
地に墜ちた落ちた鳥は 風を待ちわびる | ['地', 'に', '墜ちる', 'た', '落ちる', 'た', '鳥', 'は', '風', 'を', '待ちわびる']
祈ったところで 何も変わらない | ['祈る', 'た', 'ところ', 'で', '何', 'も', '変わる', 'ない']
《不本意な現状》を変えるのは 戦う覚悟だ | ['《', '不本意', 'だ', '現状', '》', 'を', '変える', 'の', 'は', '戦う', '覚悟', 'だ']
屍踏み越えて | ['屍', '踏み越える', 'て']
進む意思を 嗤う豚よ | ['進む', '意思', 'を', '嗤', 'う', '豚', 'よ']
家畜の安寧 | ['家畜', 'の', '安寧']
虚偽の繁栄 | ['虚偽', 'の', '繁栄']
死せる餓狼の「自由」を！ | ['死', 'せる', '餓狼', 'の', '「', '自由', '」', 'を', '!']
囚われた屈辱は 反撃の嚆だ | ['囚われる', 'た', '屈辱', 'は', '反撃', 'の', '嚆', 'だ']
城壁の其の彼方 獲物を屠る《狩人》 | ['城壁', 'の', '其の', '彼方', '獲物', 'を', '屠る', '《', '狩人', '》']

16: ハニージェットコースター | nasuo
なんかぼくよりも彼氏みたい！ | ['なんか', 'ぼく', 'より', 'も', '彼氏', 'みたい', '!']
公式離れしたモード on | ['公式', '離れる', 'する', 'た', 'モード', 'o', 'n']
ぼくだけに見えてるきみ | ['ぼく', 'だけ', 'に', '見える', 'てる', 'きみ']
とってもとってもずるい I love you! | ['とっても', 'とっても', 'ずるい', 'I', 'love', 'you', '!']
きみだけが気づいてる | ['きみ', 'だけ', 'が', '気づく', 'てる']
「あ」愛されていたい | ['「', 'あ', '」', '愛す', 'れる', 'て', 'いる', 'たい']
「い」言い訳はなし | ['「', 'い', '」', '言い訳', 'は', 'ない']
「し」知りたい知ってほしい | ['「', 'する', '」', '知る', 'たい', '知る', 'て', 'ほしい']
「て」照れて いじわる | ['「', 'て', '」', '照れる', 'て', 'いじわる']
「る」ループしていく | ['「', 'る', '」', 'ループ', 'する', 'て', 'いく']
「く」クエスチョンマークのよう | ['「', 'くる', '」', 'クエスチョンマーク', 'の', 'よう']
花びらが舞う頃 出会ってしまった | ['花びら', 'が', '舞う', '頃', '出会う', 'て', 'しまう', 'た']
ウソみたいなホントのお話 | ['ウソ', 'みたい', 'だ', 'ホント', 'の', 'お話']
甘いんじゃない？ | ['甘い', 'ん', 'じゃ', 'ない', '?']
かわいい！ | ['かわいい', '!']
だけじゃ終わんないジェットコースター | ['だけ', 'じゃ', '終わる', 'ない', 'ジェット', 'コースター']
漫画みたいな展開 って 待って待って！ | ['漫画', 'みたい', 'だ', '展開', 'って', '待つ', 'て', '待つ', 'て', '!']
はちみつとレモンは公式と違うかな？ | ['はちみつ', 'と', 'レモン', 'は', '公式', 'と', '違う', 'か', 'な', '?']
(Hey, everybody! 青春 Star!) | ['(', 'Hey', ',', 'everybody', '!', '青春', 'Star', '!', ')']
かっこいい！ | ['かっこいい', '!']
食わず嫌いハニージェットコースター | ['食わず嫌い', 'ハニージェットコースター']

17: 残響散歌 | Aimer
（ダーダラ ダラダダ） | ['(', 'ダーダラ', 'ダラダダ', ')']
（ダラダダ ダラダダ） | ['(', 'ダラダダ', 'ダラダダ', ')']
（ダーダラ ダラダダ） | ['(', 'ダーダラ', 'ダラダダ', ')']
（ダラダダ ダラ ダダ〜ラ） | ['(', 'ダラダダ', 'ダラ', 'ダダ', '〜', 'ラ', ')']
誰が袖に咲く幻花 | ['誰', 'が', '袖', 'に', '咲く', '幻花']
ただ そこに藍を落とした | ['ただ', 'そこ', 'に', '藍', 'を', '落とす', 'た']
派手に色を溶かす夜に 銀朱の月を添えて | ['派手', 'に', '色', 'を', '溶かす', '夜', 'に', '銀朱', 'の', '月', 'を', '添える', 'て']
転がるように風を切って 躓くごとに強くなった | ['転がる', 'よう', 'に', '風', 'を', '切る', 'て', '躓く', 'ごと', 'に', '強い', 'なる', 'た']
光も痛みも怒りも全部 抱きしめて | ['光', 'も', '痛み', 'も', '怒り', 'も', '全部', '抱きしめる', 'て']
選ばれなければ 選べばいい | ['選ぶ', 'れる', 'ない', 'ば', '選ぶ', 'ば', 'いい']
声よ 轟け 夜のその向こうへ | ['声', 'よ', '轟く', '夜', 'の', 'その', '向こう', 'へ']
涙で滲んでた あんなに遠くの景色まで響き渡れ | ['涙', 'で', '滲む', 'で', 'た', 'あんなに', '遠く', 'の', '景色', 'まで', '響く', '渡れる']
何を奏でて？ 誰に届けたくて？ | ['何', 'を', '奏でる', 'て', '?', '誰', 'に', '届ける', 'たい', 'て', '?']

18: なにやってもうまくいかない | meiyo
バカクソゴミクズきちゃない言葉で誰かを傷付けた | ['バカクソゴミクズ', 'くる', 'ちゃ', 'ない', '言葉', 'で', '誰', 'か', 'を', '傷付ける', 'た']
なにやってもうまくいかない | ['なに', 'やる', 'て', 'も', 'うまい', 'いく', 'ない']
脳内じゃ戦争だもんね 突っ立ってたって | ['脳', '内', 'じゃ', '戦争', 'だ', 'もん', 'ね', '突っ', '立つ', 'て', 'たつ', 'て']
なにやってもうまくいかない | ['なに', 'やる', 'て', 'も', 'うまい', 'いく', 'ない']
愛して 愛して | ['愛す', 'て', '愛す', 'て']
なにやってもうまくいかない | ['なに', 'やる', 'て', 'も', 'うまい', 'いく', 'ない']
大惨事「うっせぇわ」「低脳」聞いたことあんぞ | ['大', '惨事', '「', 'うっする', 'ぇわ', '」', '「', '低', '脳', '」', '聞く', 'た', 'こと', 'ある', 'ぞ']
なにやってもうまくいかない | ['なに', 'やる', 'て', 'も', 'うまい', 'いく', 'ない']
なにやってもうまくいかない はぁ | ['なに', 'やる', 'て', 'も', 'うまい', 'いく', 'ない', 'はぁ']
「ほら」「見て」「スゴイでしょう！」が発端になり | ['「', 'ほら', '」', '「', '見る', 'て', '」', '「', 'スゴイ', 'です', 'う', '!', '」', 'が', '発端', 'に', 'なる']
インスパイア オマージュが飛びかうフィールドで | ['インスパイア', 'オマージュ', 'が', '飛ぶ', 'かう', 'フィールド', 'で']
淡々とオリジナリティだかなんだか模索していけって？' | ['淡々', 'と', 'オリジナリティ', 'だ', 'か', 'なんだか', '模索', 'する', 'て', 'いく', 'って', "?'"]
茨でバラバラな脳内です | ['茨', 'で', 'バラバラ', 'だ', '脳', '内', 'です']
何歳下かもわかんないおこちゃまが評価されてんだ どうかしてるよな | ['何', '歳', '下', 'かも', 'わく', 'ん', 'ない', 'おこ', 'ちゃ', 'ま', 'が', '評価', 'する', 'れる', 'て', 'ん', 'だ', 'どうか', 'する', 'てる', 'よ', 'な']
って そっちのセリフよな | ['って', 'そっち', 'の', 'セリフ', 'よ', 'な']
まぁ 良いから全部聞き流して下さいどうか | ['まぁ', '良い', 'から', '全部', '聞き流す', 'て', '下さる', 'どう', 'か']
バカクソゴミクズきちゃない言葉で誰かを傷付けた | ['バカクソゴミクズ', 'くる', 'ちゃ', 'ない', '言葉', 'で', '誰', 'か', 'を', '傷付ける', 'た']
なにやってもうまくいかない | ['なに', 'やる', 'て', 'も', 'うまい', 'いく', 'ない']

19: 光るなら | Goose house
雨上がりの虹も | ['雨上がり', 'の', '虹', 'も']
凛と咲いた花も | ['凛と', '咲く', 'た', '花', 'も']
色づき溢れだす | ['色づく', '溢れる', 'だす']
茜色の空 仰ぐ君に | ['茜色', 'の', '空', '仰ぐ', '君', 'に']
あの日 恋に落ちた | ['あの', '日', '恋', 'に', '落ちる', 'た']
瞬間のドラマチック | ['瞬間', 'の', 'ドラマチック']
フィルムの中の一コマも | ['フィルム', 'の', '中', 'の', '一', 'コマ', 'も']
消えないよ 心に | ['消える', 'ない', 'よ', '心', 'に']
刻むから | ['刻む', 'から']
君だよ 君なんだよ | ['君', 'だ', 'よ', '君', 'だ', 'ん', 'だ', 'よ']
教えてくれた | ['教える', 'て', 'くれる', 'た']
暗闇も光るなら | ['暗闇', 'も', '光る', 'だ']
星空になる | ['星空', 'に', 'なる']
悲しみを笑顔に | ['悲しみ', 'を', '笑顔', 'に']
もう隠さないで | ['もう', '隠す', 'ない', 'で']
煌めくどんな星も | ['煌めく', 'どんな', '星', 'も']
君を照らすから | ['君', 'を', '照らす', 'から']

20: 心做し | majiko
ねぇ もしも全て投げ捨てられたら | ['ねぇ', 'もしも', '全て', '投げ捨てる', 'られる', 'た']
笑って生きることが楽になるの？ | ['笑う', 'て', '生きる', 'こと', 'が', '楽', 'に', 'なる', 'の', '?']
また胸が痛くなるから | ['また', '胸', 'が', '痛い', 'なる', 'から']
もう何も言わないでよ | ['もう', '何', 'も', '言う', 'ない', 'で', 'よ']
ねぇ もしも全て忘れられたなら | ['ねぇ', 'もしも', '全て', '忘れる', 'られる', 'た', 'だ']
泣かないで生きることも楽になるの？ | ['泣く', 'ない', 'で', '生きる', 'こと', 'も', '楽', 'に', 'なる', 'の', '?']
でもそんな事出来ないから | ['でも', 'そんな', '事', '出来る', 'ない', 'から']
もう何も見せないでよ | ['もう', '何', 'も', '見せる', 'ない', 'で', 'よ']
君にどれだけ近づいても | ['君', 'に', 'どれ', 'だけ', '近づく', 'て', 'も']
僕の心臓は一つだけ | ['僕', 'の', '心臓', 'は', '一つ', 'だけ']
酷いよ酷いよ もういっそ僕の体を | ['酷い', 'よ', '酷い', 'よ', 'もう', 'いっそ', '僕', 'の', '体', 'を']
壊して引き裂いて好きなようにしてよ | ['壊す', 'て', '引き裂く', 'て', '好き', 'だ', 'よう', 'に', 'する', 'て', 'よ']

21: カワキヲアメク | 美波
未熟 無ジョウ されど 美しくあれ | ['未', '熟', '無', 'ジョウ', 'されど', '美しい', 'あれ']
No destiny ふさわしく無い | ['No', 'destiny', 'ふさわしい', '無い']
こんなんじゃきっと物足りない | ['こんな', 'ん', 'じゃ', 'きっと', '物足りない']
くらい語っとけばうまくいく | ['くらい', '語る', 'とく', 'ば', 'うまい', 'いく']
物 金 愛 言 もう自己顕示飽きた | ['物', '金', '愛', '言', 'もう', '自己', '顕示', '飽きる', 'た']
既視感 何がそんな不満なんだ？ | ['既', '視', '感', '何', 'が', 'そんな', '不満', 'だ', 'ん', 'だ', '?']
散々ワガママ語っといて これ以上他に何がいる？ | ['散々', 'ワガママ', '語る', 'とく', 'て', 'これ', '以上', '他', 'に', '何', 'が', 'いる', '?']
そんなところも割と嫌いじゃ無い | ['そんな', 'ところ', 'も', '割', 'と', '嫌い', 'じゃ', '無い']
もう「聞き飽きたんだよ そのセリフ」 | ['もう', '「', '聞く', '飽きる', 'た', 'ん', 'だ', 'よ', 'その', 'セリフ', '」']
中途半端だけは嫌 | ['中途半端', 'だけ', 'は', '嫌']
もういい | ['もう', 'いう']
ああしてこうして言ってたって | ['ああ', 'する', 'て', 'こうして', '言う', 'て', 'たつ', 'て']
愛して どうして？ 言われたって | ['愛す', 'て', 'どうして', '?', '言う', 'れる', 'た', 'って']
遊びだけなら簡単で 真剣交渉無茶苦茶で | ['遊び', 'だけ', 'だ', '簡単', 'だ', '真剣', '交渉', '無茶苦茶', 'だ']
思いもしない 軽(おも)い言葉 | ['思い', 'も', 'する', 'ない', '軽', '(', 'おもい', ')', 'い', '言葉']
何度使い古すのか？ | ['何', '度', '使い古す', 'の', 'か', '?']
どうせ | ['どうせ']

22: Kamado Tanjirou no Uta (From "Demon Slayer: Kimetsu no Yaiba") [Full Version] | Akano
目を閉じて 思い出す | ['目', 'を', '閉じる', 'て', '思い出す']
過ぎ去りし あの頃を | ['過ぎ去る', 'き', 'あの', '頃', 'を']
戻れない 帰れない | ['戻れる', 'ない', '帰れる', 'ない']
広がった 深い闇 | ['広がる', 'た', '深い', '闇']
戻れない 帰れない | ['戻れる', 'ない', '帰れる', 'ない']
広がった 深い闇 | ['広がる', 'た', '深い', '闇']
泣きたくなるような 優しい音 | ['泣く', 'たい', 'なる', 'よう', 'だ', '優しい', '音']
どんなに苦しくても | ['どんなに', '苦しい', 'て', 'も']
前へ（前へ）前へ（前へ）進め 絶望断ち | ['前', 'へ', '(', '前', 'へ', ')', '前', 'へ', '(', '前', 'へ', ')', '進む', '絶望', '断つ']
失っても 失っても | ['失う', 'て', 'も', '失う', 'て', 'も']

23: 僕の戦争 | Shinsei Kamattechan
La-la-la-la | ['La', '-', 'l', 'a', '-', 'l', 'a', '-', 'l', 'a']
Ba-ba-ri-as, ra-ti-ti-ti-ras-ti-ti | ['B', 'a', '-', 'b', 'a', '-', 'r', 'i', '-', 'a', 's', ',', 'r', 'a', '-', 't', 'i', '-', 't', 'i', '-', 't', 'i', '-', 'ras', '-', 't', 'i', '-', 't', 'i']
Ba-ba-ri-as, ra-ti-ti-ti-ta | ['B', 'a', '-', 'b', 'a', '-', 'r', 'i', '-', 'a', 's', ',', 'r', 'a', '-', 't', 'i', '-', 't', 'i', '-', 't', 'i', '-', 't', 'a']
Ba-ba-ri-as, ra-ti-ti-ti-ras-ti-ti | ['B', 'a', '-', 'b', 'a', '-', 'r', 'i', '-', 'a', 's', ',', 'r', 'a', '-', 't', 'i', '-', 't', 'i', '-', 't', 'i', '-', 'ras', '-', 't', 'i', '-', 't', 'i']
Ras-tis! Ras-tis! Ra-ti-ti-la | ['Ras', '-', 'tis', '!', 'Ras', '-', 'tis', '!', 'Ra', '-', 't', 'i', '-', 't', 'i', '-', 'l', 'a']
Let's start a new life from the darkness | ['Let', "'", 's', 'start', 'a', 'new', 'life', 'from', 'the', 'darkness']
Until the light reveals the end | ['Until', 'the', 'light', 'reveals', 'the', 'end']
Fear, hatred, sorrow, desperation | ['Fear', ',', 'hatred', ',', 'sorrow', ',', 'desperation']
Even you look miserable | ['Even', 'you', 'look', 'miserable']
Look down from above | ['Look', 'down', 'from', 'above']
I feel awful | ['I', 'feel', 'awful']
The time has come | ['The', 'time', 'has', 'come']
Let's all go home | ['Let', "'", 's', 'all', 'g', 'o', 'home']
Sinister faces, growing curses | ['Sinister', 'faces', ',', 'growing', 'curses']
This is my last war | ['This', 'i', 's', 'm', 'y', 'last', 'war']
Angels playing disguised with devil's faces | ['Angels', 'playing', 'disguised', 'with', 'devil', "'", 's', 'faces']
Children cling to their coins, squeezing out their wisdom | ['Children', 'cling', 't', 'o', 'their', 'coins', ',', 'squeezing', 'out', 'their', 'wisdom']
Angels planning disguised with devil's faces | ['Angels', 'planning', 'disguised', 'with', 'devil', "'", 's', 'faces']
Children cling on to their very last coins | ['Children', 'cling', 'o', 'n', 't', 'o', 'their', 'very', 'last', 'coins']
Destruction and regeneration | ['Destruction', 'and', 'regeneration']

24: たぶん | YOASOBI
涙流すことすら無いまま | ['涙', '流す', 'こと', 'すら', '無い', 'まま']
過ごした日々の痕一つも残さずに | ['過ごす', 'た', '日々', 'の', '痕', '一つ', 'も', '残す', 'ぬ', 'に']
「さよならだ」 | ['「', 'さよなら', 'だ', '」']
一人で迎えた朝に | ['一', '人', 'で', '迎える', 'た', '朝', 'に']
鳴り響く誰かの音 | ['鳴り響く', '誰', 'か', 'の', '音']
二人で過ごした部屋で | ['二', '人', 'で', '過ごす', 'た', '部屋', 'で']
目を閉じたまま考えてた | ['目', 'を', '閉じる', 'た', 'まま', '考える', 'てる', 'た']
悪いのは誰だ? 分かんないよ | ['悪い', 'の', 'は', '誰', 'だ', '?', '分かる', 'ない', 'よ']
誰のせいでもない たぶん | ['誰', 'の', 'せい', 'だ', 'も', 'ない', 'たぶん']
僕らは何回だってきっと | ['僕ら', 'は', '何', '回', 'だって', 'きっと']
そう何年だってきっと | ['そう', '何', '年', 'だって', 'きっと']
さよならと共に終わるだけなんだ | ['さよなら', 'と共に', '終わる', 'だけ', 'だ', 'ん', 'だ']
仕方がないよきっと | ['仕方', 'が', 'ない', 'よ', 'きっと']
「おかえり」 | ['「', 'おかえり', '」']
思わず零れた言葉は違うな | ['思わず', '零れる', 'た', '言葉', 'は', '違う', 'な']
一人で迎えた朝に | ['一', '人', 'で', '迎える', 'た', '朝', 'に']
ふと想う誰かのこと | ['ふと', '想う', '誰か', 'の', 'こと']
二人で過ごした日々の | ['二', '人', 'で', '過ごす', 'た', '日々', 'の']

25: 春を告げる | yama

26: Sleeping town | whaledontsleep
あの日持って帰ったライターで煙草に火をつける | ['あの', '日', '持つ', 'て', '帰る', 'た', 'ライター', 'で', '煙草', 'に', '火', 'を', 'つける']
煙で前が見えなくなった | ['煙', 'で', '前', 'が', '見える', 'ない', 'なる', 'た']
換気扇の音 消えた | ['換気扇', 'の', '音', '消える', 'た']
部屋に残った缶ビール | ['部屋', 'に', '残る', 'た', '缶', 'ビール']
干した下着がうなだれた私に見えた | ['干す', 'た', '下着', 'が', 'うなだれる', 'た', '私', 'に', '見える', 'た']
ぐちゃぐちゃになった部屋 | ['ぐちゃぐちゃ', 'に', 'なる', 'た', '部屋']
死体みたいなぬいぐるみ | ['死体', 'みたい', 'だ', 'ぬいぐるみ']
今夜はパレード | ['今夜', 'は', 'パレード']
弱めの冷房に揺れた前髪が | ['弱める', 'の', '冷房', 'に', '揺れる', 'た', '前髪', 'が']
あの夏を何度も思い出させる | ['あの', '夏', 'を', '何', '度', 'も', '思い出す', 'せる']
ねむるまちに行こう | ['ねむる', 'まち', 'に', '行く', 'う']
ねむるまちに行こうよ | ['ねむる', 'まち', 'に', '行く', 'う', 'よ']

27: ミックスナッツ | OFFICIAL HIGE DANDISM
袋に詰められたナッツのような世間では | ['袋', 'に', '詰める', 'られる', 'た', 'ナッツ', 'の', 'よう', 'だ', '世間', 'で', 'は']
誰もがそれぞれ出会った誰かと寄り添い合ってる | ['誰', 'も', 'が', 'それぞれ', '出会う', 'た', '誰', 'か', 'と', '寄り添う', '合う', 'てる']
そこに紛れ込んだ僕らはピーナッツみたいに | ['そこ', 'に', '紛れ込む', 'だ', '僕ら', 'は', 'ピーナッツ', 'みたい', 'に']
木の実のフリしながら 微笑み浮かべる | ['木の実', 'の', 'フリ', 'する', 'ながら', '微笑む', '浮かべる']
幸せのテンプレートの上 | ['幸せ', 'の', 'テンプレート', 'の', '上']
文字通り絵に描いたうわべの裏 | ['文字通り', '絵', 'に', '描く', 'た', 'うわべ', 'の', '裏']
テーブルを囲み手を合わすその時さえ | ['テーブル', 'を', '囲む', '手', 'を', '合わす', 'その', '時', 'さえ']
ありのままでは居られないまま | ['ありのまま', 'だ', 'は', '居る', 'られる', 'ない', 'まま']
隠し事だらけ 継ぎ接ぎだらけの home, you know? | ['隠し事', 'だらけ', '継ぎ接ぎ', 'だらけ', 'の', 'home', ',', 'you', 'know', '?']
噛み砕いても無くならない | ['噛み砕く', 'て', 'も', '無くなる', 'ない']
本音が歯に挟まったまま | ['本音', 'が', '歯', 'に', '挟まる', 'た', 'まま']
不安だらけ 成り行き任せの life, and I know | ['不安', 'だらけ', '成り行き', '任せる', 'の', 'life', ',', 'and', 'I', 'know']

28: Comedy | Gen Hoshino
争い合って 壊れかかった | ['争う', '合う', 'て', '壊れる', 'かかる', 'た']
このお茶目な星で | ['この', 'お', '茶目', 'だ', '星', 'で']
生まれ落ちた日から よそ者 | ['生まれ落ちる', 'た', '日', 'から', 'よそ者']
涙枯れ果てた | ['涙', '枯れる', '果てる', 'た']
帰りゆく場所は夢の中 | ['帰る', 'ゆく', '場所', 'は', '夢', 'の', '中']
零れ落ちた 先で出会った | ['零れる', '落ちる', 'た', '先', 'で', '出会う', 'た']
ただ秘密を抱え | ['ただ', '秘密', 'を', '抱え']
普通のふりをした あなたと | ['普通', 'の', 'ふり', 'を', 'する', 'た', 'あなた', 'と']
探し諦めた | ['探す', '諦める', 'た']
私の居場所は作るものだった | ['私', 'の', '居場所', 'は', '作る', 'もの', 'だ', 'た']
あの日交わした | ['あの', '日', '交わす', 'た']
血に勝るもの | ['血', 'に', '勝る', 'もの']
心たちの契約を | ['心', 'たち', 'の', '契約', 'を']
手を繋ぎ帰ろうか | ['手', 'を', '繋ぐ', '帰る', 'う', 'か']
今日は何食べようか | ['今日', 'は', '何', '食べる', 'う', 'か']
「こんなことがあった」って | ['「', 'こんな', 'こと', 'が', 'ある', 'た', '」', 'って']
君と話したかったんだ | ['君', 'と', '話す', 'たい', 'た', 'ん', 'だ']
いつの日も | ['いつの', '日', 'も']
君となら喜劇よ | ['君', 'と', 'だ', '喜劇', 'よ']
踊る軋むベッドで | ['踊る', '軋む', 'ベッド', 'で']
笑い転げたままで | ['笑い転げる', 'た', 'まま', 'で']

29: unravel | TK from Ling tosite sigure
教えて 教えてよ その仕組みを | ['教える', 'て', '教える', 'て', 'よ', 'その', '仕組み', 'を']
僕の中に誰がいるの？ | ['僕', 'の', '中', 'に', '誰', 'が', 'いる', 'の', '?']
壊れた 壊れたよ この世界で | ['壊れる', 'た', '壊れる', 'た', 'よ', 'この', '世界', 'で']
君が笑う 何も見えずに | ['君', 'が', '笑う', '何', 'も', '見える', 'ぬ', 'に']
壊れた僕なんてさ 息を止めて | ['壊れる', 'た', '僕', 'なんて', 'さ', '息', 'を', '止める', 'て']
ほどけない もう ほどけないよ 真実さえ freeze | ['ほどける', 'ない', 'もう', 'ほどける', 'ない', 'よ', '真実', 'さえ', 'freeze']
壊せる 壊せない 狂える 狂えない | ['壊せる', '壊せる', 'ない', '狂', 'える', '狂', 'え', 'ない']
あなたを見つけて 揺れた | ['あなた', 'を', '見つける', 'て', '揺れる', 'た']
歪んだ世界にだんだん 僕は | ['歪む', 'だ', '世界', 'に', 'だんだん', '僕', 'は']
透き通って見えなくなって | ['透き通る', 'て', '見える', 'ない', 'なる', 'て']
見つけないで 僕のことを | ['見つける', 'ない', 'で', '僕', 'の', 'こと', 'を']
見つめないで | ['見つめる', 'ない', 'で']
誰かが描いた世界の中で | ['誰', 'か', 'が', '描く', 'た', '世界', 'の', '中', 'で']
あなたを傷つけたくはないよ | ['あなた', 'を', '傷つける', 'たい', 'は', 'ない', 'よ']

30: Dramaturgy | Eve
頭でわかっては嘆いた | ['頭', 'で', 'わかる', 'て', 'は', '嘆く', 'た']
転がってく様子を嗤った | ['転がる', 'て', 'く', '様子', 'を', '嗤', 'く', 'た']
寂しいとか愛とかわかんない | ['寂しい', 'とか', '愛', 'とか', 'わく', 'ん', 'ない']
人間の形は投げだしたんだ | ['人間', 'の', '形', 'は', '投げだす', 'た', 'ん', 'だ']
抱えきれない 言葉だらけの存在証明を | ['抱える', 'きれる', 'ない', '言葉', 'だらけ', 'の', '存在', '証明', 'を']
この小さな劇場から出らんない | ['この', '小さな', '劇場', 'から', '出る', 'らん', 'ない']
気づいたら最後逃げ出したい | ['気づく', 'た', '最後', '逃げ出す', 'たい']
僕ら全員演じていたんだ | ['僕ら', '全員', '演じる', 'て', 'いたむ', 'だ']
エンドロールに向かってゆくんだ | ['エンドロール', 'に', '向かう', 'て', 'ゆく', 'ん', 'だ']
さあ 皆必死に役を演じて傍観者なんていないのさ | ['さあ', '皆', '必死', 'に', '役', 'を', '演じる', 'て', '傍観', '者', 'なんて', 'いる', 'ない', 'の', 'さ']
"ワタシ"なんてないの | ['"', 'ワタ', 'シ', '"', 'なんて', 'ない', 'の']
どこにだって居ないよ | ['どこ', 'に', 'だって', '居る', 'ない', 'よ']
ずっと僕は 何者にもなれないで | ['ずっと', '僕', 'は', '何者', 'に', 'も', 'なれる', 'ない', 'で']
僕ら今 さあさあ 喰らいあって | ['僕ら', '今', 'さあ', 'さあ', '喰らう', 'ある', 'て']
延長戦 サレンダーして | ['延長', '戦', 'サレンダー', 'する', 'て']
メーデー 淡い愛想 | ['メーデー', '淡い', '愛想']
垂れ流し 言の愛憎 | ['垂れ流し', '言', 'の', '愛憎']
ドラマチックな展開をどっか期待してんだろう | ['ドラマチック', 'だ', '展開', 'を', 'どっか', '期待', 'する', 'て', 'ん', 'だ', 'う']
君も YES YES 息を呑んで | ['君', 'も', 'YES', 'YES', '息', 'を', '呑む', 'で']
采配は そこにあんだ | ['采配', 'は', 'そこ', 'に', 'あむ', 'だ']
ヘッドショット 騒ぐ想いも | ['ヘッド', 'ショット', '騒ぐ', '想い', 'も']
その心 撃ち抜いて さあ | ['その', '心', '撃ち抜く', 'て', 'さあ']
まだ見ぬ糸を引いて 黒幕のお出ましさ | ['まだ', '見る', 'ぬ', '糸', 'を', '引く', 'て', '黒幕', 'の', 'お出まし', 'さ']
その目に映るのは | ['その', '目', 'に', '映る', 'の', 'は']

31: Lost Umbrella | 稲葉曇
僕を連れてって | ['僕', 'を', '連れる', 'て', 'く', 'て']
浸み込んでしまう前に | ['浸る', 'み', '込む', 'で', 'しまう', '前', 'に']
見えないまま掴みたいとか | ['見える', 'ない', 'まま', '掴む', 'たい', 'と', 'か']
どうせ叶わないからさ | ['どうせ', '叶う', 'ない', 'から', 'さ']
あぁ 手はずっと濡れていて | ['あぁ', '手', 'は', 'ずっと', '濡れる', 'て', 'いる', 'て']
いつか落としてしまうこと | ['いつか', '落とす', 'て', 'しまう', 'こと']
まだ気付いてなかった | ['まだ', '気付く', 'てる', 'ない', 'た']
細かい雨が目に浸みるのも | ['細かい', '雨', 'が', '目', 'に', '浸る', 'みる', 'の', 'も']
湿った息が喉に詰まるのも | ['湿る', 'た', '息', 'が', '喉', 'に', '詰まる', 'の', 'も']
容にならないものを背負った僕は | ['容', 'に', 'なる', 'ない', 'もの', 'を', '背負う', 'た', '僕', 'は']
案外楽だったのかもしんないな | ['案外', '楽', 'だ', 'た', 'の', 'かも', 'しん', 'ない', 'な']
声になれなかった分だけ | ['声', 'に', 'なれる', 'ない', 'た', '分', 'だけ']
目の前で邪魔している霧雨に | ['目', 'の', '前', 'で', '邪魔', 'する', 'て', 'いる', '霧雨', 'に']
傘を翳して逃げ惑いたいよ | ['傘', 'を', '翳す', 'て', '逃げ惑う', 'たい', 'よ']
僕を連れてって | ['僕', 'を', '連れる', 'て', 'く', 'て']
浸み込んでしまう前に | ['浸る', 'み', '込む', 'で', 'しまう', '前', 'に']
見えないままやられちゃうとか | ['見える', 'ない', 'まま', 'やる', 'れる', 'ちゃう', 'とか']

32: 色香水 | Yoh kamiyama
きっと消えない 今日は言えない | ['きっと', '消える', 'ない', '今日', 'は', '言える', 'ない']
元どおりにはもうできない | ['元', 'どおり', 'に', 'は', 'もう', 'できる', 'ない']
あの頃に 君を残したまま | ['あの', '頃', 'に', '君', 'を', '残す', 'た', 'まま']
記憶の中では 晴れ間の部屋 | ['記憶', 'の', '中', 'で', 'は', '晴れ間', 'の', '部屋']
惹かれ合えばサラバ 知りたくない | ['惹く', 'れる', '合う', 'ば', 'サラバ', '知る', 'たい', 'ない']
思い出せば今も ふわっと香る | ['思い出す', 'ば', '今', 'も', 'ふわっと', '香る']
君と僕は同じ 色香水 | ['君', 'と', '僕', 'は', '同じ', '色', '香水']
ほんの少し 背伸びをして歩いた道 | ['ほんの', '少し', '背伸び', 'を', 'する', 'て', '歩く', 'た', '道']
ビードロの靴 移り変わる季節模様 | ['ビードロ', 'の', '靴', '移り変わる', '季節', '模様']
きっと消えない 今日は言えない | ['きっと', '消える', 'ない', '今日', 'は', '言える', 'ない']
元どおりにはもうできない | ['元', 'どおり', 'に', 'は', 'もう', 'できる', 'ない']
あの頃に隠した 本物はどこ | ['あの', '頃', 'に', '隠す', 'た', '本物', 'は', 'どこ']
怒ってくれない 解ってくれない | ['怒る', 'て', 'くれる', 'ない', '解る', 'て', 'くれる', 'ない']

33: Koko de Iki wo Shite | eill
君の少し汗臭いシャツの | ['君', 'の', '少し', '汗', '臭い', 'シャツ', 'の']
隣を歩くだけでいいの | ['隣', 'を', '歩く', 'だけ', 'だ', 'いい', 'の']
突然の雨に打たれて | ['突然', 'の', '雨', 'に', '打つ', 'れる', 'て']
拗ねた夜にキスを落とした | ['拗ねる', 'た', '夜', 'に', 'キス', 'を', '落とす', 'た']
振り返ればいつも笑った私でいるよ | ['振り返る', 'ば', 'いつも', '笑う', 'た', '私', 'で', 'いる', 'よ']
「お願い」ねぇ敵わない未来なんてさ | ['「', 'お願い', '」', 'ねぇ', '敵', 'わ', 'ない', '未来', 'なんて', 'さ']
今すぐに拐って | ['今', 'すぐ', 'に', '拐う', 'て']
真っ新な世界で | ['真っ', '新', 'だ', '世界', 'で']
君に名を付けるなら「私のヒーロー」 | ['君', 'に', '名', 'を', '付ける', 'だ', '「', '私', 'の', 'ヒーロー', '」']
真っ直ぐな願いが 止まった時を越えて | ['真っ直ぐ', 'だ', '願い', 'が', '止まる', 'た', '時', 'を', '越える', 'て']
君以外はもう何もいらないと | ['君', '以外', 'は', 'もう', '何', 'も', 'いる', 'ない', 'と']
いつもここで息をして | ['いつも', 'ここ', 'で', '息', 'を', 'する', 'て']
上手く息もできない世界で | ['上手い', '息む', 'できる', 'ない', '世界', 'で']

34: ブルーバード | Ikimonogakari
飛翔いたら 戻らないと言って | ['飛翔', 'いる', 'た', '戻る', 'ない', 'と', '言う', 'て']
目指したのは 蒼い 蒼い あの空 | ['目指す', 'た', 'の', 'は', '蒼い', '蒼い', 'あの', '空']
"悲しみ"はまだ覚えられず | ['"', '悲しみ', '"', 'は', 'まだ', '覚える', 'られる', 'ぬ']
"切なさ"は今つかみはじめた | ['"', '切ない', 'さ', '"', 'は', '今', 'つかむ', 'はじめる', 'た']
あなたへと抱く この感情も | ['あなた', 'へ', 'と', '抱く', 'この', '感情', 'も']
今"言葉"に変わっていく | ['今', '"', '言葉', '"', 'に', '変わる', 'て', 'いく']
未知なる世界の 遊迷から目覚めて | ['未知', 'なり', '世界', 'の', '遊迷', 'から', '目覚める', 'て']
この羽根を広げ 飛び立つ | ['この', '羽根', 'を', '広げる', '飛び立つ']
飛翔いたら 戻らないと言って | ['飛翔', 'いる', 'た', '戻る', 'ない', 'と', '言う', 'て']
探したのは 白い 白い あの雲 | ['探す', 'た', 'の', 'は', '白い', '白い', 'あの', '雲']

35: Fukashigi no Carte | Selphius
Sprich es nicht aus, weck mich nicht auf aus diesem Tagtraum | ['Sprich', 'e', 's', 'nicht', 'aus', ',', 'weck', 'mich', 'nicht', 'auf', 'aus', 'diesem', 'Tagtraum']
Das, was du suchst, wirst du in mir nicht seh'n | ['Das', ',', 'was', 'd', 'u', 'suchst', ',', 'wirst', 'd', 'u', 'in', 'mir', 'nicht', 'seh', "'", 'n']
Niemand begreift, was hier geschrieben steht | ['Niemand', 'begreift', ',', 'was', 'hier', 'geschrieben', 'steht']
Aber vielleicht find ich's ja doch heraus | ['Aber', 'vielleicht', 'find', 'ich', "'", 's', 'j', 'a', 'doch', 'heraus']
Frag mich nicht, wie es wirklich ist | ['Frag', 'mich', 'nicht', ',', 'wie', 'e', 's', 'wirklich', 'ist']
Wie du es selbst nach allem sehen willst, liegt ganz bei dir | ['Wie', 'd', 'u', 'e', 's', 'selbst', 'nach', 'allem', 'sehen', 'willst', ',', 'liegt', 'ganz', 'bei', 'dir']
"Irgendwer, irgendwer bestimmt..." | ['"', 'Irgendwer', ',', 'irgendwer', 'bestimmt', '.', '.', '.', '"']
Zwing dich nicht, | ['Zwing', 'dich', 'nicht', ',']
Irgendwann kann jemand mich genau so lieben, wie ich bin | ['Irgendwann', 'kann', 'jemand', 'mich', 'genau', 's', 'o', 'lieben', ',', 'wie', 'ich', 'bin']
Halt es geheim, flüster Bye-Bye und lass es gut sein | ['Halt', 'e', 's', 'geheim', ',', 'flüster', 'Bye', '-', 'Bye', 'und', 'lass', 'e', 's', 'gut', 'sein']
Ich hab die Welt ohne dich neu erlebt | ['Ich', 'hab', 'die', 'Welt', 'ohne', 'dich', 'neu', 'erlebt']
Niemand begreift, was hier geschrieben steht | ['Niemand', 'begreift', ',', 'was', 'hier', 'geschrieben', 'steht']

36: Kimi No Toriko | Huỳnh Hữu Khang
君の虜になってしまえばきっと | ['君', 'の', '虜', 'に', 'なる', 'て', 'しまう', 'ば', 'きっと']
この夏は充実するのもっと | ['この', '夏', 'は', '充実', 'する', 'の', 'もっと']
噂のドリーミンガール忘れないで | ['噂', 'の', 'ドリーミンガール', '忘れる', 'ない', 'で']
でも気持ちを伝えてしまえばいつか | ['でも', '気持ち', 'を', '伝える', 'て', 'しまう', 'ば', 'いつか']
この夢は覚めてしまうだろうな | ['この', '夢', 'は', '覚める', 'て', 'しまう', 'だ', 'う', 'な']
青い影が揺れる街角 | ['青い', '影', 'が', '揺れる', '街角']
君の虜になってしまえばきっと | ['君', 'の', '虜', 'に', 'なる', 'て', 'しまう', 'ば', 'きっと']
この夏は充実するのもっと | ['この', '夏', 'は', '充実', 'する', 'の', 'もっと']
噂のドリーミンガール忘れないで | ['噂', 'の', 'ドリーミンガール', '忘れる', 'ない', 'で']
でも気持ちを伝えてしまえばいつか | ['でも', '気持ち', 'を', '伝える', 'て', 'しまう', 'ば', 'いつか']
この夢は覚めてしまうだろうな | ['この', '夢', 'は', '覚める', 'て', 'しまう', 'だ', 'う', 'な']
青い影が揺れる街角 | ['青い', '影', 'が', '揺れる', '街角']
君の虜になってしまえばきっと | ['君', 'の', '虜', 'に', 'なる', 'て', 'しまう', 'ば', 'きっと']
この夏は充実するのもっと | ['この', '夏', 'は', '充実', 'する', 'の', 'もっと']

37: Koino Uta | Yunomi
あとどれくらいの距離を月へ歩いたら | ['あと', 'どれ', 'くらい', 'の', '距離', 'を', '月', 'へ', '歩く', 'た']
あとどれくらいの寒い夜を重ねたら | ['あと', 'どれ', 'くらい', 'の', '寒い', '夜', 'を', '重ねる', 'た']
あとどれくらいのさよならを流したら | ['あと', 'どれ', 'くらい', 'の', 'さよなら', 'を', '流す', 'た']
まぶたの奥の泉が枯れ果てる、とか | ['まぶた', 'の', '奥', 'の', '泉', 'が', '枯れる', '果てる', '、', 'と', 'か']
千年後もきっと続くだろう | ['千', '年', '後', 'も', 'きっと', '続く', 'だ', 'う']
そう思ってた空洞を | ['そう', '思う', 'てる', 'た', '空洞', 'を']
満たしてあふれてしまうほどの | ['満たす', 'て', 'あふれる', 'て', 'しまう', 'ほど', 'の']
この気持ちはなんだ？ | ['この', '気持ち', 'は', 'なん', 'だ', '?']
新しい風を春は運んでくれるだろう | ['新しい', '風', 'を', '春', 'は', '運ぶ', 'で', 'くれる', 'だ', 'う']
あぁ、風が吹くのがきっと還る場所なんだろう | ['あぁ', '、', '風', 'が', '吹く', 'の', 'が', 'きっと', '還る', '場所', 'だ', 'ん', 'だ', 'う']
変わらないでしょう | ['変わる', 'ない', 'です', 'う']
夏の暑さも、金魚も | ['夏', 'の', '暑い', 'さ', 'も', '、', '金魚', 'も']
花火が消えたら星を夜通し数えよう | ['花火', 'が', '消える', 'た', '星', 'を', '夜通し', '数える', 'う']
色褪せる木々、凍てつく指先、重ねた日々の灯火 | ['色褪せる', '木々', '、', '凍てつく', '指先', '、', '重ねる', 'た', '日々', 'の', '灯火']
降り積もる雪に埋もれないような消えない跡を残しに | ['降り積もる', '雪', 'に', '埋もれる', 'ない', 'よう', 'だ', '消える', 'ない', '跡', 'を', '残す', 'に']

38: Akuma no Ko | Ai Higuchi
鉄の弾が 正義の証明 | ['鉄', 'の', '弾', 'が', '正義', 'の', '証明']
貫けば 英雄に近づいた | ['貫く', 'ば', '英雄', 'に', '近づく', 'た']
その目を閉じて 触れてみれば | ['その', '目', 'を', '閉じる', 'て', '触れる', 'て', 'みる', 'ば']
同じ形 同じ体温の悪魔 | ['同じ', '形', '同じ', '体温', 'の', '悪魔']
僕はダメで あいつはいいの？ | ['僕', 'は', 'ダメ', 'だ', 'あいつ', 'は', 'いい', 'の', '?']
そこに壁があっただけなのに | ['そこ', 'に', '壁', 'が', 'ある', 'た', 'だけ', 'だ', 'のに']
生まれてしまった 運命嘆くな | ['生まれる', 'て', 'しまう', 'た', '運命', '嘆く', 'な']
僕らはみんな 自由なんだから | ['僕ら', 'は', 'みんな', '自由', 'だ', 'ん', 'だ', 'から']
鳥のように 羽があれば | ['鳥', 'の', 'よう', 'に', '羽', 'が', 'ある', 'ば']
どこへだって行けるけど | ['どこ', 'へ', 'だって', '行ける', 'けど']
帰る場所が なければ | ['帰る', '場所', 'が', 'ない', 'ば']
きっとどこへも行けない | ['きっと', 'どこ', 'へ', 'も', '行ける', 'ない']

39: Chikatto Chika Chika | Konomi Kohara
よーい、よーい | ['よー', 'いる', '、', 'よー', 'いる']
どーんだよ！ | ['どー', 'ん', 'だ', 'よ', '!']
秀知院学園 | ['秀', '知', '院', '学園']
周知の事実 | ['周知', 'の', '事実']
みんな憧れの生徒会 | ['みんな', '憧れる', 'の', '生徒', '会']
（ポクポクポクポクポクポクポン！） | ['(', 'ポクポクポクポクポクポクポン', '!', ')']
会長とかぐやさん | ['会長', 'とか', 'ぐやさん']
石上くんと書記の千花 | ['石上', 'くん', 'と', '書記', 'の', '千花']
ゴールデンメンバーと思いませんか？ | ['ゴールデン', 'メンバー', 'と', '思う', 'ます', 'ん', 'か', '?']
（書記の千花、書記の千花、ラー！） | ['(', '書記', 'の', '千花', '、', '書記', 'の', '千花', '、', 'ラー', '!', ')']
乱れた国で生きる私たち | ['乱れる', 'た', '国', 'で', '生きる', '私', 'たち']
誰もが本音、隠してるけど | ['誰', 'も', 'が', '本音', '、', '隠す', 'てる', 'けど']
どんな問題もラブ探偵チカが | ['どんな', '問題', 'も', 'ラブ', '探偵', 'チカ', 'が']
解決するわ | ['解決', 'する', 'わ']
（IQ3 でも任せなさい！） | ['(', 'IQ', '3', 'でも', '任せる', 'なさる', '!', ')']
しゅきしゅき書記書記初期設定（ドーン！） | ['する', 'ゅきしゅき', '書記', '書記', '初期', '設定', '(', 'ドーン', '!', ')']
うかうかしてたらすぐ卒業（フゥ！） | ['うかうか', 'する', 'てる', 'た', 'すぐ', '卒業', '(', 'フゥ', '!', ')']
ちゅきちゅきどきどきフォーチュンテラー | ['ちる', 'ゅきちゅきどきどき', 'フォーチュンテラー']

40: インフェルノ | Mrs. GREEN APPLE
照らすは闇 | ['照らす', 'は', '闇']
僕らは歩き慣れてきた日々も淘汰 | ['僕ら', 'は', '歩く', '慣れる', 'て', 'くる', 'た', '日々', 'も', '淘汰']
夢は安泰な暮らしだが | ['夢', 'は', '安泰', 'だ', '暮らし', 'だ', 'が']
刺激不足故にタラタラ | ['刺激', '不足', '故に', 'タラタラ']
照らすは熄み | ['照らす', 'は', '熄', 'みる']
僕らの歩き慣れていた道はどこだ | ['僕ら', 'の', '歩き', '慣れる', 'て', 'いる', 'た', '道', 'は', 'どこ', 'だ']
時はたまに癪だが | ['時', 'は', 'たまに', '癪', 'だ', 'が']
温もりに包まれ只 | ['温もり', 'に', '包む', 'れる', '只']
炎が立つ | ['炎', 'が', '立つ']
導の方へ | ['導', 'の', '方', 'へ']
思い出すは優しいメロディー | ['思い出す', 'は', '優しい', 'メロディー']
永遠は無いんだと 無いんだと云フ | ['永遠', 'は', '無い', 'ん', 'だ', 'と', '無い', 'ん', 'だ', 'と', '云', 'フ']
それもまたイイねと笑ってみる | ['それ', 'も', 'また', 'イイ', 'ね', 'と', '笑う', 'て', 'みる']
輝けばいつかは光も絶える | ['輝く', 'ば', 'いつか', 'は', '光', 'も', '絶える']
僕らは命の火が消えるその日まで歩いてゆく | ['僕ら', 'は', '命', 'の', '火', 'が', '消える', 'その', '日', 'まで', '歩く', 'て', 'ゆく']

41: Black Rover | VK Blanka
単純なステージ | ['単純', 'だ', 'ステージ']
渇くほど願い 水が糸を伝い | ['渇く', 'ほど', '願う', '水', 'が', '糸', 'を', '伝う']
誰かにかなう困難なステージ | ['誰', 'か', 'に', 'かなう', '困難', 'だ', 'ステージ']
頂上を示す模様 | ['頂上', 'を', '示す', '模様']
水平線が宙を舞う | ['水平', '線', 'が', '宙', 'を', '舞う']
何度くじかれても | ['何', '度', 'くじく', 'れる', 'て', 'も']
その希望を両手に 僕ら波を打って | ['その', '希望', 'を', '両手', 'に', '僕ら', '波', 'を', '打つ', 'て']
つばさをみせろと叫ぶんだ | ['つばさ', 'を', 'みせる', 'と', '叫ぶ', 'ん', 'だ']
Get down | ['Get', 'down']
We all let you know this time | ['W', 'e', 'all', 'let', 'you', 'know', 'this', 'time']
Can you bring me down | ['Can', 'you', 'bring', 'm', 'e', 'down']
Back up, get far of the sky, black rover | ['Back', 'up', ',', 'get', 'far', 'o', 'f', 'the', 'sky', ',', 'black', 'rover']
いつかともにみよう | ['いつか', 'ともに', 'みる', 'う']
今は黒に染めよう | ['今', 'は', '黒', 'に', '染める', 'う']
こんなふざけた時代 | ['こんな', 'ふざける', 'た', '時代']
Black rover | ['Black', 'rover']
何回もPlay | ['何', '回', 'も', 'Play']
見えるのに見ない ためしてもみない | ['見える', 'の', 'に', '見る', 'ない', 'ためす', 'て', 'も', 'みる', 'ない']

42: うっせぇわ | Ado
正しさとは 愚かさとは | ['正しい', 'さ', 'と', 'は', '愚か', 'さ', 'と', 'は']
それが何か見せつけてやる | ['それ', 'が', '何', 'か', '見せつける', 'て', 'やる']
ちっちゃな頃から優等生 | ['ちっちゃな', '頃', 'から', '優等生']
気づいたら大人になっていた | ['気づく', 'た', '大人', 'に', 'なる', 'て', 'いる', 'た']
ナイフの様な思考回路 | ['ナイフ', 'の', '様', 'だ', '思考', '回路']
持ち合わせる訳もなく | ['持ち合わせる', '訳', 'も', 'ない']
でも遊び足りない 何か足りない | ['でも', '遊び', '足りる', 'ない', '何', 'か', '足りる', 'ない']
困っちまうこれは誰かのせい | ['困る', 'ちまう', 'これ', 'は', '誰', 'か', 'の', 'せい']
あてもなくただ混乱するエイデイ | ['あて', 'も', 'ない', 'ただ', '混乱', 'する', 'エイデイ']
それもそっか | ['それ', 'も', 'そっ', 'か']
最新の流行は当然の把握 | ['最新', 'の', '流行', 'は', '当然', 'の', '把握']
経済の動向も通勤時チェック | ['経済', 'の', '動向', 'も', '通勤', '時', 'チェック']
純情な精神で入社しワーク | ['純情', 'だ', '精神', 'で', '入社', 'する', 'ワーク']
社会人じゃ当然のルールです | ['社会', '人', 'じゃ', '当然', 'の', 'ルール', 'です']
はぁ？うっせぇうっせぇうっせぇわ | ['はぁ', '?', 'うっする', 'ぇうっせぇうっせぇわ']
あなたが思うより健康です | ['あなた', 'が', '思う', 'より', '健康', 'です']
一切合切凡庸な | ['一切合切', '凡庸', 'だ']

43: 楽園 | Fujifabric
右へ行くか左行くか どうだいどうだい | ['右', 'へ', '行く', 'か', '左', '行く', 'か', 'どう', 'だい', 'どう', 'だい']
僕と違うならばここで さよなら | ['僕', 'と', '違う', 'だ', 'ば', 'ここ', 'で', 'さよなら']
あっちの蜜こっちの蜜 うんざり | ['あっち', 'の', '蜜', 'こっち', 'の', '蜜', 'うんざり']
味見してるような そんな暇はない | ['味見', 'する', 'てる', 'よう', 'だ', 'そんな', '暇', 'は', 'ない']
先へ急げ 未開の楽園 | ['先', 'へ', '急げる', '未開', 'の', '楽園']
灼熱の衝動 どこにある | ['灼熱', 'の', '衝動', 'どこ', 'に', 'ある']
掴みたけりゃ 手を伸ばせ | ['掴む', 'たい', '手', 'を', '伸ばせる']
枯れ果てた 楽園(ここ)にとどまるなら | ['枯れる', '果てる', 'た', '楽園', '(', 'ここ', ')', 'に', 'とどまる', 'だ']
君だとしても 僕は牙を剥く | ['君', 'だ', 'として', 'も', '僕', 'は', '牙', 'を', '剥く']
からまって 紐解いて 飛び越えて 歪んだ世界 | ['からまる', 'て', '紐解く', 'て', '飛び越える', 'て', '歪む', 'だ', '世界']
終わって 始まって 這い上がって 願った時代 | ['終わる', 'て', '始まる', 'て', '這う', '上がる', 'て', '願う', 'た', '時代']

44: フィクション | sumika
さあ 今日も始めましょうか | ['さあ', '今日', 'も', '始める', 'ます', 'う', 'か']
昨日 挟んだ栞の続きから | ['昨日', '挟む', 'だ', '栞', 'の', '続き', 'から']
楽あれば苦もあり | ['楽', 'ある', 'ば', '苦', 'も', 'ある']
ストーリーは波の随に | ['ストーリー', 'は', '波', 'の', '随', 'に']
深い海を抜け | ['深い', '海', 'を', '抜ける']
空飛ぶ街に繰り出し | ['空', '飛ぶ', '街', 'に', '繰り出す']
そこから降りれなくなり | ['そこ', 'から', '降りる', 'れる', 'ない', 'なる']
脈絡のないような展開も | ['脈絡', 'の', 'ない', 'よう', 'だ', '展開', 'も']
きっとオンリーなストーリー | ['きっと', 'オンリー', 'だ', 'ストーリー']
高鳴る所には忘れず付箋を | ['高鳴る', '所', 'に', 'は', '忘れる', 'ぬ', '付箋', 'を']
時々くるマイナスな面に備えて 重宝して | ['時々', 'くる', 'マイナス', 'だ', '面', 'に', '備える', 'て', '重宝', 'する', 'て']
ひらり ひらり | ['ひらり', 'ひらり']
めくり めくる | ['めくる', 'めくる']
ストーリー ストーリー | ['ストーリー', 'ストーリー']
喜怒哀楽 忙しい | ['喜怒哀楽', '忙しい']
ひらり ひらり | ['ひらり', 'ひらり']
めくり めくる | ['めくる', 'めくる']
ストーリー ストーリー | ['ストーリー', 'ストーリー']
忙しない ネバーエンディング | ['忙しない', 'ネバーエンディング']

45: 足跡 | the peggies
さよならさ行かなくちゃ | ['さよなら', 'さ', '行く', 'ない', 'ちゃ']
僕よ僕になれと叫ぶ | ['僕', 'よ', '僕', 'に', 'なる', 'と', '叫ぶ']
たどり着く先で君に | ['たどり着く', '先', 'で', '君', 'に']
もう一度出会いたいのさ | ['もう一度', '出会う', 'たい', 'の', 'さ']
いつだって君越しの世界を見てた | ['いつ', 'だって', '君', '越し', 'の', '世界', 'を', '見る', 'てる', 'た']
音も無く溢した涙も知らず | ['音', 'も', '無い', '溢', 'する', 'た', '涙', 'も', '知る', 'ぬ']
大丈夫って言葉が嫌いなんて | ['大丈夫', 'って', '言葉', 'が', '嫌い', 'なんて']
急に呟くから何も言えなくなる | ['急', 'に', '呟く', 'から', '何', 'も', '言える', 'ない', 'なる']
薄暗い空の先を信じたい | ['薄暗い', '空', 'の', '先', 'を', '信じる', 'たい']
憧れは自分を打ち消す為のものじゃない | ['憧れる', 'は', '自分', 'を', '打ち消す', '為', 'の', 'もの', 'じゃ', 'ない']
さよならさもう行かなくちゃ | ['さよなら', 'さ', 'もう', '行く', 'ない', 'ちゃ']
僕よ僕になれと叫ぶ | ['僕', 'よ', '僕', 'に', 'なる', 'と', '叫ぶ']
何故だろう傷付いたって | ['何故', 'だ', 'う', '傷', '付く', 'た', 'って']
答えを探してる | ['答え', 'を', '探す', 'てる']
さよならさいつかまた会おう | ['さよなら', 'さ', 'いつか', 'また', '会う', 'う']
君よ君であれと願う | ['君', 'よ', '君', 'だ', 'ある', 'と', '願う']

46: Anoko secret | Eve
思い出したって出したってきっと | ['思い出す', 'た', 'って', '出す', 'た', 'って', 'きっと']
僕の事なんてどこにもないよ | ['僕', 'の', '事', 'なんて', 'どこ', 'に', 'も', 'ない', 'よ']
あの娘 シークレットシークレット内情 | ['あの', '娘', 'シークレットシークレット', '内情']
届かないなんて 落ち込んで解消 | ['届く', 'ない', 'なんて', '落ち込む', 'で', '解消']
話したいんだってたいんだってずっと | ['話す', 'たい', 'ん', 'だって', 'たい', 'ん', 'だって', 'ずっと']
くだらないような他愛無い話を | ['くだらない', 'よう', 'だ', '他愛', '無い', '話', 'を']
でも話したら話したできっと | ['でも', '話す', 'た', '話す', 'た', 'で', 'きっと']
この心臓がもうもたないよ | ['この', '心臓', 'が', 'もう', 'もつ', 'ない', 'よ']
帰り道の途中で 君と出会ってしまった | ['帰り道', 'の', '途中', 'で', '君', 'と', '出会う', 'て', 'しまう', 'た']
これは偶然なんかじゃない 向かうのさ | ['これ', 'は', '偶然', 'なんか', 'じゃ', 'ない', '向かう', 'の', 'さ']
わからないないないや 心がステップして | ['わかる', 'ない', 'ない', 'ない', 'や', '心', 'が', 'ステップ', 'する', 'て']
この想いよ今 届いてくれよって | ['この', '想い', 'よ', '今', '届く', 'て', 'くれる', 'よ', 'って']
何やったって ダメなんだって 味方して | ['何', 'やる', 'たって', 'ダメ', 'だ', 'ん', 'だって', '味方', 'する', 'て']
君がいないないないと 不安になって | ['君', 'が', 'いる', 'ない', 'ない', 'ない', 'と', '不安', 'に', 'なる', 'て']

47: 命に嫌われている。 | majiko
「死にたいなんて言うなよ」 | ['「', '死ぬ', 'たい', 'なんて', '言う', 'な', 'よ', '」']
「諦めないで生きろよ」 | ['「', '諦める', 'ない', 'で', '生きる', 'よ', '」']
そんな歌が正しいなんて馬鹿げてるよな | ['そんな', '歌', 'が', '正しい', 'なんて', '馬鹿げる', 'てる', 'よ', 'な']
実際自分は死んでもよくて | ['実際', '自分', 'は', '死ぬ', 'で', 'も', 'よい', 'て']
周りが死んだら悲しくて | ['周り', 'が', '死ぬ', 'だ', '悲しい', 'て']
「それが嫌だから」っていうエゴなんです | ['「', 'それ', 'が', '嫌', 'だ', 'から', '」', 'っていう', 'エゴ', 'だ', 'ん', 'です']
他人が生きてもどうでもよくて | ['他人', 'が', '生きる', 'て', 'も', 'どう', 'でも', 'よい', 'て']
誰かを嫌うこともファッションで | ['誰', 'か', 'を', '嫌う', 'こと', 'も', 'ファッション', 'で']
それでも「平和に生きよう」 | ['それでも', '「', '平和', 'に', '生きる', 'う', '」']
なんて素敵なことでしょう | ['なんて', '素敵', 'だ', 'こと', 'です', 'う']
画面の先では誰かが死んで | ['画面', 'の', '先', 'で', 'は', '誰', 'か', 'が', '死ぬ', 'で']
それを嘆いて誰かが歌って | ['それ', 'を', '嘆く', 'て', '誰', 'か', 'が', '歌う', 'て']
それに感化された少年が | ['それに', '感化', 'する', 'れる', 'た', '少年', 'が']
ナイフを持って走った | ['ナイフ', 'を', '持つ', 'て', '走る', 'た']
僕らは命に嫌われている | ['僕ら', 'は', '命', 'に', '嫌う', 'れる', 'て', 'いる']
価値観もエゴも押し付けて | ['価値', '観', 'も', 'エゴ', 'も', '押し付ける', 'て']
いつも誰かを殺したい歌を | ['いつも', '誰', 'か', 'を', '殺す', 'たい', '歌', 'を']
簡単に電波で流した | ['簡単', 'に', '電波', 'で', '流す', 'た']
僕らは命に嫌われている | ['僕ら', 'は', '命', 'に', '嫌う', 'れる', 'て', 'いる']
軽々しく死にたいだとか | ['軽々しい', '死ぬ', 'たい', 'だ', 'と', 'か']
軽々しく命を見てる | ['軽々しい', '命', 'を', '見る', 'てる']
僕らは命に嫌われている | ['僕ら', 'は', '命', 'に', '嫌う', 'れる', 'て', 'いる']

48: 麻痺 | yama
痺れちゃうくらいに怖くてさ | ['痺れる', 'ちゃう', 'くらい', 'に', '怖い', 'て', 'さ']
足が竦んで竦んでいた | ['足', 'が', '竦む', 'で', '竦む', 'で', 'いる', 'た']
その時 落ちた涙が今も忘れらんないよな | ['その', '時', '落ちる', 'た', '涙', 'が', '今', 'も', '忘れる', 'らん', 'ない', 'よ', 'な']
どうしようか 逆境は慣れてないから | ['どう', 'する', 'う', 'か', '逆境', 'は', '慣れる', 'てる', 'ない', 'から']
曖昧な覚悟しか出来てないよな | ['曖昧', 'だ', '覚悟', 'しか', '出来る', 'てる', 'ない', 'よ', 'な']
細胞が硬直し始めては | ['細胞', 'が', '硬直', 'する', '始める', 'て', 'は']
あんまりな未来を見せてくんだな | ['あんまり', 'だ', '未来', 'を', '見せる', 'て', 'くむ', 'だ', 'な']
あの頃の僕ら ただ人を羨んでは | ['あの', '頃', 'の', '僕ら', 'ただ', '人', 'を', '羨む', 'で', 'は']
見えない何かに怒ってさ | ['見える', 'ない', '何', 'か', 'に', '怒る', 'て', 'さ']
片足で跨げる様な 段差をずっと睨んで | ['片足', 'で', '跨げる', '様', 'だ', '段差', 'を', 'ずっと', '睨む', 'で']
言葉も出なくて掻きむしっていた | ['言葉', 'も', '出る', 'ない', 'て', '掻きむしる', 'て', 'いる', 'た']
痺れちゃうくらいに怖くてさ | ['痺れる', 'ちゃう', 'くらい', 'に', '怖い', 'て', 'さ']

49: センチメートル | the peggies
運命なんて言えない | ['運命', 'なんて', '言える', 'ない']
あと何センチ近づけば良いんだろう | ['あと', '何', 'センチ', '近づく', 'ば', '良い', 'ん', 'だ', 'う']
君がいいと言えないまま見つめてる後ろ姿 | ['君', 'が', 'いい', 'と', '言える', 'ない', 'まま', '見つめる', 'てる', '後ろ姿']
余裕のない日々です | ['余裕', 'の', 'ない', '日々', 'です']
デートなんて自信がないな | ['デート', 'なんて', '自信', 'が', 'ない', 'な']
君が眩しい程 | ['君', 'が', '眩しい', '程']
僕は情けなくなってく | ['僕', 'は', '情けない', 'なる', 'て', 'く']
(会えない時間＋君が笑った瞬間)÷2のこのときめきと | ['(', '会える', 'ない', '時間', '+', '君', 'が', '笑う', 'た', '瞬間', ')', '÷', '2', 'の', 'この', 'ときめき', 'と']
不器用な僕×強がりな君は案外プラスかもって | ['不器用', 'だ', '僕', '×', '強がる', 'な', '君', 'は', '案外', 'プラス', 'かも', 'って']
気づいてしまったら最後 | ['気づく', 'て', 'しまう', 'た', '最後']
まだね運命なんて言えない | ['まだ', 'ね', '運命', 'なんて', '言える', 'ない']
あと何センチ近づけばいいんだろう | ['あと', '何', 'センチ', '近づく', 'ば', 'いい', 'ん', 'だ', 'う']

50: Inochi No Tabekata | Eve
足りないもの探して バックパッカー | ['足りる', 'ない', 'もの', '探す', 'て', 'バックパッカー']
かっとなっては やっちまった | ['かっと', 'なる', 'て', 'は', 'やる', 'ちまう', 'た']
急展開に期待しなくたって | ['急', '展開', 'に', '期待', 'する', 'ない', 'たって']
きっと君は来ないってないってば | ['きっと', '君', 'は', '来る', 'ない', 'ってな', 'いう', 'て', 'ば']
"ビビディバビデブー" | ['"', 'ビビディバビデブー', '"']
おまじないみたいなもんさ | ['おまじない', 'みたい', 'だ', 'もん', 'さ']
帰りを今も待ち望んでは | ['帰り', 'を', '今', 'も', '待ち望む', 'で', 'は']
その感動はまた走り去った | ['その', '感動', 'は', 'また', '走り去る', 'た']
（これじゃないと あれじゃないと） | ['(', 'これ', 'じゃ', 'ない', 'と', 'あれ', 'じゃ', 'ない', 'と', ')']
（焦りだけが募るようだ） | ['(', '焦り', 'だけ', 'が', '募る', 'よう', 'だ', ')']
隣に握りしめる手が欲しかった | ['隣', 'に', '握りしめる', '手', 'が', '欲しい', 'た']
温もりを知らぬまま | ['温もり', 'を', '知る', 'ぬ', 'まま']
心まで貧しくなって | ['心', 'まで', '貧しい', 'なる', 'て']
グレイの海を彷徨った | ['グレイ', 'の', '海', 'を', '彷徨', 'く', 'た']
美は満ち溢れているんだ | ['美', 'は', '満ちる', '溢れる', 'て', 'いる', 'ん', 'だ']
見過ごすな | ['見過ごす', 'な']
夜が明ける前に酔いを醒まして | ['夜', 'が', '明ける', '前', 'に', '酔い', 'を', '醒ます', 'て']
時間がないんだ君には | ['時間', 'が', 'ない', 'ん', 'だ', '君', 'に', 'は']

51: ないものねだり - Revenge THE FIRST TAKE | KANA-BOON
One two | ['One', 'two']
いつだってワガママばっかで 子供みたいね | ['いつ', 'だって', 'ワガママ', 'ばっか', 'だ', '子供', 'みたい', 'ね']
君だってないものねだり 何が欲しいの？教えて | ['君', 'だって', 'ないものねだり', '何', 'が', '欲しい', 'の', '?', '教える', 'て']
教えて | ['教える', 'て']
あっち見たりそっちを見たり 美人が好きなのね | ['あっち', '見る', 'たり', 'そっち', 'を', '見る', 'たり', '美人', 'が', '好き', 'だ', 'の', 'ね']
君だってさっきのカフェの 店員さんがタイプでしょ？答えて | ['君', 'だって', 'さっき', 'の', 'カフェ', 'の', '店員', 'さん', 'が', 'タイプ', 'です', '?', '答える', 'て']
ゆらゆらゆらゆら僕の心、風に吹かれて | ['ゆらゆら', 'ゆらゆら', '僕', 'の', '心', '、', '風', 'に', '吹く', 'れる', 'て']
ゆらゆらゆらゆら君の心、はなればなれ | ['ゆらゆら', 'ゆらゆら', '君', 'の', '心', '、', 'は', 'なる', 'ば', 'なる']

52: おもかげ (produced by Vaundy) | milet
I feel like, feel like, feel like leaving it to the flow | ['I', 'feel', 'like', ',', 'feel', 'like', ',', 'feel', 'like', 'leaving', 'i', 't', 't', 'o', 'the', 'flow']
Feel like, feel like, oh, oh, oh, oh-oh | ['Feel', 'like', ',', 'feel', 'like', ',', 'o', 'h', ',', 'o', 'h', ',', 'o', 'h', ',', 'o', 'h', '-', 'o', 'h']
もう 何も見えないふりをしていた | ['もう', '何', 'も', '見える', 'ない', 'ふり', 'を', 'する', 'て', 'いる', 'た']
悲しみが見えすぎたから | ['悲しみ', 'が', '見える', 'すぎる', 'た', 'から']
影も僕を見ていた | ['影', 'も', '僕', 'を', '見る', 'て', 'いる', 'た']
「君のことはわかるから」 | ['「', '君', 'の', 'こと', 'は', 'わかる', 'から', '」']
失くしたことで流れ着いた | ['失', 'くい', 'た', 'こと', 'で', '流れ着く', 'た']
なによりも ほんとのこと | ['なに', 'より', 'も', 'ほんと', 'の', 'こと']
僕らは | ['僕ら', 'は']
こうして | ['こうして']
どこにも | ['どこ', 'に', 'も']
見せない愛で満たしてる 本当 | ['見せる', 'ない', '愛', 'で', '満たす', 'てる', '本当']
僕らは | ['僕ら', 'は']
いつの日も | ['いつの', '日', 'も']
見えない愛で満たしてる 本当 | ['見える', 'ない', '愛', 'で', '満たす', 'てる', '本当']
Feel like, feel like, feel like leaving it to the flow | ['Feel', 'like', ',', 'feel', 'like', ',', 'feel', 'like', 'leaving', 'i', 't', 't', 'o', 'the', 'flow']

53: 聖者たち | People In The Box
街は眠れど 建物はずっと建設中さ | ['街', 'は', '眠れる', 'ど', '建物', 'は', 'ずっと', '建設', '中', 'さ']
都市計画遂行中 | ['都市', '計画', '遂行', '中']
噛み合う蛇 モーフィングした環状線 | ['噛み合う', '蛇', 'モーフィング', 'する', 'た', '環状', '線']
エンドルフィン煽って いけよゴーゴーゴー | ['エン', 'ドルフィン', '煽る', 'て', 'いく', 'よ', 'ゴーゴーゴー']
夜の空に上昇する魂 | ['夜', 'の', '空', 'に', '上昇', 'する', '魂']
行進と信仰は常軌を逸したクイズのようだ | ['行進', 'と', '信仰', 'は', '常軌', 'を', '逸す', 'た', 'クイズ', 'の', 'よう', 'だ']
クイズのようだ | ['クイズ', 'の', 'よう', 'だ']
まだ空っぽな明日は | ['まだ', '空っぽ', 'だ', '明日', 'は']
限りなく黒に近いグレイ | ['限り', 'ない', '黒', 'に', '近い', 'グレイ']
なにかにもなれずに | ['なに', 'か', 'に', 'も', 'なれる', 'ぬ', 'に']
限りなく黒に近いグレイ | ['限り', 'ない', '黒', 'に', '近い', 'グレイ']
中東でもインドでもアフリカでも | ['中東', 'で', 'も', 'インド', 'で', 'も', 'アフリカ', 'で', 'も']
放送する象徴は当然に超高層 | ['放送', 'する', '象徴', 'は', '当然', 'に', '超', '高層']

None type
None type
56: Raison Detre | Eve
漂うこの空気にストップ ただ矛盾を抱いている | ['漂う', 'この', '空気', 'に', 'ストップ', 'ただ', '矛盾', 'を', '抱く', 'て', 'いる']
今更猛スピードでスタート切ったって | ['今更', '猛', 'スピード', 'で', 'スタート', '切る', 'た', 'って']
どうやったって追いつきゃしないぜメーデー | ['どう', 'やる', 'たって', '追いつく', 'する', 'ない', 'ぜ', 'メーデー']
強がりに嫌気がさしている | ['強がる', 'に', '嫌気', 'が', 'さす', 'て', 'いる']
弱音も吐けないままでいる 弱音も吐けないままでいる | ['弱音', 'も', '吐ける', 'ない', 'まま', 'で', 'いる', '弱音', 'も', '吐ける', 'ない', 'まま', 'で', 'いる']
損得のものさしでぽいって捨てられ | ['損得', 'の', 'ものさし', 'で', 'ぽい', 'って', '捨てる', 'られる']
よそいきの顔してまたやり過ごす | ['よそ', 'いき', 'の', '顔', 'する', 'て', 'また', 'やり過ごす']
存在もないようなもんだ 誰もわかっちゃいないや | ['存在', 'も', 'ない', 'よう', 'だ', 'もん', 'だ', '誰', 'も', 'わかる', 'ちゃ', 'いる', 'ない', 'や']
感情論に縋ってなんて憚れば堕ちる | ['感情', '論', 'に', '縋る', 'て', 'なんて', '憚', 'る', 'ば', '堕ちる']
だけど 夢に目覚めた君は何をみるの | ['だけど', '夢', 'に', '目覚める', 'た', '君', 'は', '何', 'を', 'みる', 'の']
最低な日を超えて 最善の成る方へ | ['最低', 'だ', '日', 'を', '超える', 'て', '最善', 'の', '成る', '方', 'へ']
どうしたんだ 期待なんてもうしてられないから | ['どう', 'する', 'た', 'ん', 'だ', '期待', 'なんて', 'もうす', 'てる', 'られる', 'ない', 'から']
その時をじっと待っている | ['その', '時', 'を', 'じっと', '待つ', 'て', 'いる']
曖昧な視界に立って 際限のない方へ | ['曖昧', 'だ', '視界', 'に', '立つ', 'て', '際限', 'の', 'ない', '方', 'へ']
こんな気持ちさえも捨てきれないのなら | ['こんな', '気持ち', 'さえ', 'も', '捨てる', 'きれる', 'ない', 'の', 'だ']
混ざって混ざって生まれ変わるまで | ['混ざる', 'て', '混ざる', 'て', '生まれ変わる', 'まで']
終わらない夢を | ['終わる', 'ない', '夢', 'を']

None type
58: カタオモイ | Aimer
例えば君の顔に昔よりシワが増えても それでもいいんだ | ['例えば', '君', 'の', '顔', 'に', '昔', 'より', 'シワ', 'が', '増える', 'て', 'も', 'それでも', 'いい', 'ん', 'だ']
僕がギターを思うように弾けなくなっても 心の歌は君で溢れているよ | ['僕', 'が', 'ギター', 'を', '思う', 'よう', 'に', '弾ける', 'ない', 'なる', 'て', 'も', '心', 'の', '歌', 'は', '君', 'で', '溢れる', 'て', 'いる', 'よ']
高い声も出せずに思い通り歌えない | ['高い', '声', 'も', '出せる', 'ぬ', 'に', '思い通り', '歌える', 'ない']
それでもうなずきながら一緒に歌ってくれるかな | ['それでも', 'うなずく', 'ながら', '一緒', 'に', '歌う', 'て', 'くれる', 'か', 'な']
割れんばかりの拍手も 響き渡る歓声もいらない | ['割れる', 'ん', 'ばかり', 'の', '拍手', 'も', '響き', '渡る', '歓声', 'も', 'いる', 'ない']
君だけ 分かってよ 分かってよ | ['君', 'だけ', '分かる', 'て', 'よ', '分かる', 'て', 'よ']
Darlin' 夢が叶ったの | ['Darlin', "'", '夢', 'が', '叶う', 'た', 'の']
お似合いの言葉が見つからないよ | ['お似合い', 'の', '言葉', 'が', '見つかる', 'ない', 'よ']
Darlin' 夢が叶ったの | ['Darlin', "'", '夢', 'が', '叶う', 'た', 'の']
「愛してる」 | ['「', '愛す', 'てる', '」']

59: Brave Shine | Aimer
左手に隠した | ['左手', 'に', '隠す', 'た']
願いは願いのままで | ['願い', 'は', '願い', 'の', 'まま', 'で']
覚めない幻見てた | ['覚める', 'ない', '幻', '見る', 'てる', 'た']
右手には空の記憶 | ['右手', 'に', 'は', '空', 'の', '記憶']
誰もしらない世界の果て | ['誰', 'も', 'しる', 'ない', '世界', 'の', '果て']
やまない雨にうたれていた | ['やむ', 'ない', '雨', 'に', 'うつ', 'れる', 'て', 'いる', 'た']
守りたいものを守れる強さ | ['守る', 'たい', 'もの', 'を', '守れる', '強い', 'さ']
それを信じられなくなる弱さ | ['それ', 'を', '信じる', 'られる', 'ない', 'なる', '弱い', 'さ']
すべてを受け入れて | ['すべて', 'を', '受け入れる', 'て']
未来を探す | ['未来', 'を', '探す']
Brave shine | ['Brave', 'shine']
手を伸ばせばまだ | ['手', 'を', '伸ばす', 'ば', 'まだ']
Stay the night | ['Stay', 'the', 'night']
傷だらけの夜 | ['傷', 'だらけ', 'の', '夜']
You save my life | ['You', 'save', 'm', 'y', 'life']

60: il vento d'oro | Yugo Kanno
Feel the hip hop, if you can rock | ['Feel', 'the', 'hip', 'hop', ',', 'i', 'f', 'you', 'can', 'rock']
Need you, kick that | ['Need', 'you', ',', 'kick', 'that']
Turn up the bass | ['Turn', 'u', 'p', 'the', 'bass']
Go crazy, one by one | ['Go', 'crazy', ',', 'one', 'b', 'y', 'one']
Brrt, stick up, hahaha | ['Brrt', ',', 'stick', 'up', ',', 'hahaha']
Ye, ye, yeah, kick it, kick it loud | ['Y', 'e', ',', 'y', 'e', ',', 'yeah', ',', 'kick', 'it', ',', 'kick', 'i', 't', 'loud']
And you forgot to turn up the bass! | ['And', 'you', 'forgot', 't', 'o', 'turn', 'u', 'p', 'the', 'bass', '!']
Go crazy, it's a dangerous world | ['Go', 'crazy', ',', 'it', "'", 's', 'a', 'dangerous', 'world']
Brrt, stick up, Giogio | ['Brrt', ',', 'stick', 'up', ',', 'Giogio']
Buc-ci-ci-ci-cirati! | ['Buc', '-', 'c', 'i', '-', 'c', 'i', '-', 'c', 'i', '-', 'cirati', '!']
Yeah, kick it, kick it loud | ['Yeah', ',', 'kick', 'it', ',', 'kick', 'i', 't', 'loud']
Need you, kick that | ['Need', 'you', ',', 'kick', 'that']
Turn up the bass | ['Turn', 'u', 'p', 'the', 'bass']
Go crazy, one by one | ['Go', 'crazy', ',', 'one', 'b', 'y', 'one']
Brrt, stick up, hahaha | ['Brrt', ',', 'stick', 'up', ',', 'hahaha']
Ye, ye, yeah, kick it, kick it loud | ['Y', 'e', ',', 'y', 'e', ',', 'yeah', ',', 'kick', 'it', ',', 'kick', 'i', 't', 'loud']
And you forgot to turn up the bass! | ['And', 'you', 'forgot', 't', 'o', 'turn', 'u', 'p', 'the', 'bass', '!']
Go crazy, it's a dangerous world | ['Go', 'crazy', ',', 'it', "'", 's', 'a', 'dangerous', 'world']
Brrt, stick up, Giogio | ['Brrt', ',', 'stick', 'up', ',', 'Giogio']
Giogio | ['Giogio']
Golden Wind | ['Golden', 'Wind']
Giogio | ['Giogio']
Golden Wind | ['Golden', 'Wind']

61: JOJO SONO CHINO SADAME | Hiroaki Tommy Tominaga
Sora! Koboreochita futatsu no hoshi ga | ['Sora', '!', 'Koboreochita', 'futatsu', 'n', 'o', 'hoshi', 'g', 'a']
Hikari to yami no minamo suikomareteyuku | ['Hikari', 't', 'o', 'yami', 'n', 'o', 'minamo', 'suikomareteyuku']
Hikiau you ni kasanaru hamon | ['Hikiau', 'you', 'n', 'i', 'kasanaru', 'hamon']
Hokori no michi wo yuku mono ni taiyou no michibiki wo | ['Hokori', 'n', 'o', 'michi', 'w', 'o', 'yuku', 'mono', 'n', 'i', 'taiyou', 'n', 'o', 'michibiki', 'w', 'o']
Yabou no hate wo mezasu mono ni ikenie wo | ['Yabou', 'n', 'o', 'hate', 'w', 'o', 'mezasu', 'mono', 'n', 'i', 'ikenie', 'w', 'o']
(Jojo! Jojo! Jojo! Jojo! Jojo!) | ['(', 'Jojo', '!', 'Jojo', '!', 'Jojo', '!', 'Jojo', '!', 'Jojo', '!', ')']
Furueru hodo kokoro moetsukiru hodo atsuku | ['Furueru', 'hodo', 'kokoro', 'moetsukiru', 'hodo', 'atsuku']
Sono te kara hanate kodou karada minagiru yuuki de | ['Sono', 't', 'e', 'kara', 'hanate', 'kodou', 'karada', 'minagiru', 'yuuki', 'd', 'e']
Mayou inaki kakugo ni 'Kassai' wo! | ['Mayou', 'inaki', 'kakugo', 'ni', "'", 'Kassai', "'", 'w', 'o', '!']
Sono chi no sadame Jojo | ['Sono', 'chi', 'n', 'o', 'sadame', 'Jojo']

62: STAND PROUD | Jin Hashimoto
そして、集いしスターダスト | ['そして', '、', '集う', 'き', 'スター', 'ダスト']
100年目の目醒めに 呼ばれて | ['1', '0', '0', '年', '目', 'の', '目', '醒める', 'に', '呼ぶ', 'れる', 'て']
男たちは向かう | ['男', 'たち', 'は', '向かう']
時の砂を越えるJourney | ['時', 'の', '砂', 'を', '越える', 'Journey']
鎖のよう連なる 絡み合う宿命 | ['鎖', 'の', 'よう', '連なる', '絡み合う', '宿命']
白金で断つ運命 | ['白金', 'で', '断つ', '運命']
Stand up! Stand up! Stand up! | ['Stand', 'up', '!', 'Stand', 'up', '!', 'Stand', 'up', '!']
打ち込むのは | ['打ち込む', 'の', 'は']
All right now. All right now. All right now | ['All', 'right', 'now', '.', 'All', 'right', 'now', '.', 'All', 'right', 'now']
誇りのBullet | ['誇り', 'の', 'Bullet']
Break you down. Break you down. Break you down | ['Break', 'you', 'down', '.', 'Break', 'you', 'down', '.', 'Break', 'you', 'down']
拳放つ 聖なるヴィジョン Stand proud! | ['拳', '放つ', '聖なる', 'ヴィジョン', 'Stand', 'proud', '!']
封印じられてた「時」に | ['封印', 'じ', 'られる', 'てる', 'た', '「', '時', '」', 'に']

63: ピースサイン - Peace Sign | Kenshi Yonezu
いつか僕らの上をスレスレに | ['いつか', '僕ら', 'の', '上', 'を', 'スレスレ', 'に']
通りすぎていったあの飛行機を | ['通る', 'すぎる', 'て', 'いく', 'た', 'あの', '飛行機', 'を']
不思議なくらいに憶えてる | ['不思議', 'だ', 'くらい', 'に', '憶える', 'てる']
意味もないのに 何故か | ['意味', 'も', 'ない', 'のに', '何故か']
不甲斐なくて泣いた日の夜に | ['不甲斐ない', 'て', '泣く', 'た', '日', 'の', '夜', 'に']
ただ強くなりたいと願ってた | ['ただ', '強い', 'なる', 'たい', 'と', '願う', 'てる', 'た']
そのために必要な勇気を | ['その', 'ため', 'に', '必要', 'だ', '勇気', 'を']
探し求めていた | ['探し求める', 'て', 'いる', 'た']
残酷な運命が定まっているとして | ['残酷', 'だ', '運命', 'が', '定まる', 'て', 'いる', 'として']
それがいつの日か僕の前に現れるとして | ['それ', 'が', 'いつ', 'の', '日', 'か', '僕', 'の', '前', 'に', '現れる', 'として']
ただ一瞬 この一瞬 息ができるなら | ['ただ', '一瞬', 'この', '一瞬', '息', 'が', 'できる', 'だ']
どうでもいいと思えた | ['どう', 'でも', 'いい', 'と', '思える', 'た']
その心を | ['その', '心', 'を']
もう一度 遠くへ行け 遠くへ行けと | ['もう一度', '遠く', 'へ', '行く', '遠く', 'へ', '行く', 'と']
僕の中で誰かが歌う | ['僕', 'の', '中', 'で', '誰', 'か', 'が', '歌う']
どうしようもないほど熱烈に | ['どう', 'しよう', 'も', 'ない', 'ほど', '熱烈', 'に']
いつだって目を腫らした君が二度と | ['いつ', 'だって', '目', 'を', '腫らす', 'た', '君', 'が', '二度と']
悲しまないように笑える | ['悲しむ', 'ない', 'よう', 'に', '笑える']
そんなヒーローになるための歌 | ['そんな', 'ヒーロー', 'に', 'なる', 'ため', 'の', '歌']

64: Answer | Lilas Ikuta
このままどこまで | ['この', 'まま', 'どこ', 'まで']
歩いていくんだろう | ['歩く', 'て', 'いく', 'ん', 'だ', 'う']
鏡にうつる自分を見つめて | ['鏡', 'に', 'うつる', '自分', 'を', '見つめる', 'て']
答えは見つからない | ['答え', 'は', '見つかる', 'ない']
まだ少し欠けてる心 | ['まだ', '少し', '欠ける', 'てる', '心']
抱き締めていたい今は | ['抱き締める', 'て', 'いる', 'たい', '今', 'は']
うずくまって涙こぼした夜 | ['うずくまる', 'て', '涙', 'こぼす', 'た', '夜']
孤独が僕を育てていく | ['孤独', 'が', '僕', 'を', '育てる', 'て', 'いく']
不器用なだけに不甲斐ない | ['不器用', 'だ', 'だけ', 'に', '不甲斐ない']
自分を恨んでも | ['自分', 'を', '恨む', 'で', 'も']
続く日々の中で | ['続く', '日々', 'の', '中', 'で']
夢を見ていたい | ['夢', 'を', '見る', 'て', 'いる', 'たい']
朝陽が昇る | ['朝陽', 'が', '昇る']
「いつか」を追いかける | ['「', 'いつか', '」', 'を', '追いかける']
伸ばした手では | ['伸ばす', 'た', '手', 'で', 'は']
まだ届かない場所 | ['まだ', '届く', 'ない', '場所']
この胸の奥に住みつく臆病が | ['この', '胸', 'の', '奥', 'に', '住みつく', '臆病', 'が']

65: シンデレラ | Cidergirl

66: Yoruwahonoka | Eve
今日も生きてしまったな これで何年 | ['今日', 'も', '生きる', 'て', 'しまう', 'た', 'な', 'これ', 'で', '何', '年']
息を吐くように吐いた嘘は何千 | ['息', 'を', '吐く', 'よう', 'に', '吐く', 'た', '嘘', 'は', '何', '千']
這い蹲って けんもほろろになって | ['這い蹲う', 'て', 'けんもほろろ', 'に', 'なる', 'て']
目が回るわ | ['目', 'が', '回る', 'わ']
そのかかとすり潰した靴でどこ行くの | ['その', 'かかと', 'すり潰す', 'た', '靴', 'で', 'どこ', '行く', 'の']
蔑んだその目を閉まっておくれよ | ['蔑む', 'だ', 'その', '目', 'を', '閉まる', 'て', 'おくれる']
紫煙を燻らせる染みついた部屋で一人 | ['紫煙', 'を', '燻る', 'せる', '染みつく', 'た', '部屋', 'で', '一', '人']
仄日は切なく | ['仄日', 'は', '切ない']
あなたに寄り添い | ['あなた', 'に', '寄り添う']
今すぐに言いたい | ['今', 'すぐ', 'に', '言う', 'たい']
痛い 浮ついた花心 | ['痛い', '浮つく', 'た', '花心']
哀 会いたい言葉が | ['哀', '会う', 'たい', '言葉', 'が']
焼き増しした記憶を辿り | ['焼き増し', 'する', 'た', '記憶', 'を', '辿る']
寂しい星を待って | ['寂しい', '星', 'を', '待つ', 'て']
愛されたいを知ってしまった少年 | ['愛す', 'れる', 'たい', 'を', '知る', 'て', 'しまう', 'た', '少年']

67: wavy flow | Aimer
紺碧の斜陽 染まる眼差し | ['紺碧', 'の', '斜陽', '染まる', '眼差し']
揺らいでくる 誓いの向こうへ 走った | ['揺らぐ', 'で', 'くる', '誓う', 'の', '向こう', 'へ', '走る', 'た']
過ぎ去りし日々を 夢見がちだった願いは 深海へ眠って | ['過ぎ去る', 'き', '日々', 'を', '夢見', 'がち', 'だ', 'た', '願い', 'は', '深海', 'へ', '眠る', 'て']
波に凍る手を 溶かす声がして 目醒める瞬間を感じてた | ['波', 'に', '凍る', '手', 'を', '溶かす', '声', 'が', 'する', 'て', '目', '醒める', '瞬間', 'を', '感じる', 'てる', 'た']
ここにきて 約束追って | ['ここ', 'に', 'くる', 'て', '約束', '追って']

68: CRAZY NOISY BIZARRE TOWN | THE DU
すれ違ってく顔のない視線 胸の穴が変えてった日常 | ['すれ違う', 'て', 'く', '顔', 'の', 'ない', '視線', '胸', 'の', '穴', 'が', '変える', 'て', 'く', 'た', '日常']
境界なんてなく出会う アタリマエの奇妙 uh yeah | ['境界', 'なんて', 'ない', '出会う', 'アタリマエ', 'の', '奇妙', 'u', 'h', 'yeah']
いつを通りの朝が うわっ面で笑う | ['いつ', 'を', '通り', 'の', '朝', 'が', 'う', 'わっ', '面', 'で', '笑う']
正体不明のままに 惹かれあう mystery | ['正体', '不明', 'の', 'まま', 'に', '惹く', 'れる', 'あう', 'mystery']
はじまりも言わず じっと潜んでる、この町のどこか | ['はじまる', 'も', '言う', 'ぬ', 'じっと', '潜む', 'でる', '、', 'この', '町', 'の', 'どこ', 'か']
だけど今日も上々に 文句なんか言いあって | ['だけど', '今日', 'も', '上々', 'に', '文句', 'なんか', '言いあう', 'て']

69: the WORLD | Nightmare
広がる闇の中 交わし合った 革命の契り | ['広がる', '闇', 'の', '中', '交わす', '合う', 'た', '革命', 'の', '契り']
愛した故に芽生えた悪の花 | ['愛す', 'た', '故', 'に', '芽生える', 'た', '悪', 'の', '花']
これから先訪れるであろう全てを | ['これから', '先', '訪れる', 'だ', 'ある', 'う', '全て', 'を']
誰にも邪魔させるワケにはいかないから | ['誰', 'に', 'も', '邪魔', 'する', 'せる', 'ワケ', 'に', 'は', 'いく', 'ない', 'から']
果実が告げた未来 理性を忘れた街 | ['果実', 'が', '告げる', 'た', '未来', '理性', 'を', '忘れる', 'た', '街']
黒く歪んだ現在を 夢、理想に変える | ['黒い', '歪む', 'だ', '現在', 'を', '夢', '、', '理想', 'に', '変える']
どうして? 僕はこわれた救世主? | ['どうして', '?', '僕', 'は', 'こわれる', 'た', '救世主', '?']

70: JoJo Sonochino Kioku~end of THE WORLD~ | JO☆STARS 〜TOMMY,Coda,JIN〜
深海へ 眠った物語が | ['深海', 'へ', '眠る', 'た', '物語', 'が']
灼熱の 砂を波立てて | ['灼熱', 'の', '砂', 'を', '波', '立てる', 'て']
宿命を また呼び覚ます | ['宿命', 'を', 'また', '呼び覚ます']
終着の地を焦がす 寡黙な炎 | ['終着', 'の', '地', 'を', '焦がす', '寡黙', 'だ', '炎']
おびき寄せられた 神々の化身 | ['おびき寄せる', 'られる', 'た', '神', '々', 'の', '化身']
恐れを知らぬ 剣が貫く | ['恐れ', 'を', '知る', 'ぬ', '剣', 'が', '貫く']
目指す場所とは まだ見ぬさだめ | ['目指す', '場所', 'と', 'は', 'まだ', '見る', 'ぬ', 'さだめる']
近づいて来る 決戦のとき | ['近づく', 'て', '来る', '決戦', 'の', 'とき']
打つべき period は star platinum | ['打つ', 'べし', 'period', 'は', 'star', 'platinum']
始まってしまった物語に 奪われたままの時に | ['始まる', 'て', 'しまう', 'た', '物語', 'に', '奪う', 'れる', 'た', 'まま', 'の', '時', 'に']
今 終わりを告げるため 歩き続ける crusaders | ['今', '終わる', 'を', '告げる', 'ため', '歩く', '続ける', 'crusaders']
空白のラストページに その拳を叩き込め | ['空白', 'の', 'ラスト', 'ページ', 'に', 'その', '拳', 'を', '叩き込む']
End of the world その血の記憶 | ['End', 'o', 'f', 'the', 'world', 'その', '血', 'の', '記憶']
オラオラオラオラ | ['オラオラオラオラ']

71: オトノナルホウヘ→ | Goose house
遠く離れた 場所にいる時も | ['遠い', '離れる', 'た', '場所', 'に', 'いる', '時', 'も']
僕らの声が 届きますように | ['僕ら', 'の', '声', 'が', '届く', 'ます', 'よう', 'に']
迷ったときは オトノナルホウヘ→ | ['迷う', 'た', 'とき', 'は', 'オトノナルホウヘ', '→']
笑う門にはちゃんと（ちゃんと） | ['笑う', '門', 'に', 'は', 'ちゃんと', '(', 'ちゃんと', ')']
福はやって来るから | ['福', 'は', 'やって来る', 'から']
泣いて腫らしたその目だって | ['泣く', 'て', '腫らす', 'た', 'その', '目だつ', 'て']
ほら 笑顔が似合う | ['ほら', '笑顔', 'が', '似合う']
息が詰まる こんな世の中で | ['息', 'が', '詰まる', 'こんな', '世の中', 'で']
出会えたんだ | ['出会える', 'た', 'ん', 'だ']
色とりどりの世界を | ['色とりどり', 'の', '世界', 'を']
一緒に見に行こう | ['一緒', 'に', '見る', 'に', '行く', 'う']
頑張り屋の君だから | ['頑張り', '屋', 'の', '君', 'だ', 'から']
壁にも ぶつかるでしょう | ['壁', 'に', 'も', 'ぶつかる', 'です', 'う']
でも もう平気 ひとりでは | ['でも', 'もう', '平気', 'ひとり', 'で', 'は']
背負わないでいいんだよ | ['背負う', 'ない', 'で', 'いい', 'ん', 'だ', 'よ']
君が笑えば 僕も笑うから | ['君', 'が', '笑う', 'ば', '僕', 'も', '笑う', 'から']

72: 好きだ | YOASOBI
急に居ても立っても居られず | ['急', 'に', '居る', 'て', 'も', '立つ', 'て', 'も', '居る', 'れる', 'ぬ']
友達にSOS | ['友達', 'に', 'SOS']
話聞いて欲しいんだ | ['話', '聞く', 'て', '欲しい', 'ん', 'だ']
やっぱり私 彼のことが | ['やっぱり', '私', '彼', 'の', 'こと', 'が']
「そんなこと知ってるもう何度も」 | ['「', 'そんな', 'こと', '知る', 'てる', 'もう', '何', '度', 'も', '」']
薄っぺらなそんなリアクション | ['薄っぺら', 'だ', 'そんな', 'リアクション']
耳にタコが出来ててもいいから聞いて | ['耳', 'に', 'タコ', 'が', '出来る', 'てる', 'て', 'も', 'いい', 'から', '聞く', 'て']
我慢出来ないんだ | ['我慢', '出来る', 'ない', 'ん', 'だ']
いざ彼に四回目の告白を | ['いざ', '彼', 'に', '四', '回', '目', 'の', '告白', 'を']
嗚呼 期待薄い片思いなんて苦いだけ | ['嗚呼', '期待', '薄い', '片思い', 'なんて', '苦い', 'だけ']
友達でいいよ | ['友達', 'だ', 'いい', 'よ']
すれ違いざま 一言交わすだけ | ['すれ違い', 'ざま', '一言', '交わす', 'だけ']

73: 新時代 | Ado
新時代はこの未来だ | ['新', '時代', 'は', 'この', '未来', 'だ']
世界中全部 変えてしまえば 変えてしまえば | ['世界中', '全部', '変える', 'て', 'しまう', 'ば', '変える', 'て', 'しまう', 'ば']
ジャマモノ やなもの なんて消して | ['ジャマモノ', 'や', 'だ', 'もの', 'なんて', '消す', 'て']
この世とメタモルフォーゼしようぜ | ['この世', 'と', 'メタモルフォーゼ', 'する', 'う', 'ぜ']
ミュージック キミが起こす マジック | ['ミュージック', 'キミ', 'が', '起こす', 'マジック']
目を閉じれば未来が開いて | ['目', 'を', '閉じる', 'ば', '未来', 'が', '開く', 'て']
いつまでも終わりが来ないようにって | ['いつ', 'まで', 'も', '終わる', 'が', '来る', 'ない', 'よう', 'に', 'って']
この歌を歌うよ | ['この', '歌', 'を', '歌う', 'よ']
Do you wanna play? リアルゲーム ギリギリ | ['Do', 'you', 'wanna', 'play', '?', 'リアル', 'ゲーム', 'ギリギリ']
綱渡りみたいな旋律 認めない戻れない忘れたい | ['綱渡り', 'みたい', 'だ', '旋律', '認める', 'ない', '戻れる', 'ない', '忘れる', 'たい']
夢の中に居させて I wanna be free | ['夢', 'の', '中', 'に', '居る', 'させる', 'て', 'I', 'wanna', 'b', 'e', 'free']

74: Brand New World (feat. Minase Mashiro) | U-ske
駆け出した朝の始まり | ['駆け出す', 'た', '朝', 'の', '始まり']
新しい今日の日に | ['新しい', '今日', 'の', '日', 'に']
何となく足がちょっと軽くて | ['何となく', '足', 'が', 'ちょっと', '軽い', 'て']
どこまでも行ける気がしたり | ['どこ', 'まで', 'も', '行ける', '気', 'が', 'する', 'たり']
考えなくったってほら | ['考える', 'ない', 'たって', 'ほら']
きっと何かが待ってる | ['きっと', '何', 'か', 'が', '待つ', 'てる']
この先はどんな風だって | ['この', '先', 'は', 'どんな', '風', 'だって']
分からなくてまとまんなくて | ['分かる', 'ない', 'て', 'まとまる', 'ない', 'て']
始まるストーリー | ['始まる', 'ストーリー']
今追いかけてく | ['今', '追いかける', 'て', 'く']

75: Okinimesumama | Eve
淡々 言葉を吐いた | ['淡々', '言葉', 'を', '吐く', 'た']
あんな思い出に泣いたのは | ['あんな', '思い出', 'に', '泣く', 'た', 'の', 'は']
今日で終わりにしないか | ['今日', 'で', '終わる', 'に', 'する', 'ない', 'か']
ワン ツー の合図を待って | ['ワン', 'ツー', 'の', '合図', 'を', '待つ', 'て']
ユーエンミー手を取りあったのは | ['ユーエンミー', '手', 'を', '取りあう', 'た', 'の', 'は']
僕の勇気ある行動 フェイズ | ['僕', 'の', '勇気', 'ある', '行動', 'フェイズ']
立ち止まんないでいいんだからね | ['立ち止まる', 'ない', 'で', 'いい', 'ん', 'だ', 'から', 'ね']
空々しいな この人生 | ['空々しい', 'な', 'この', '人生']
できないだなんて 言わないでね 言わないでね | ['できる', 'ない', 'だ', 'なんて', '言う', 'ない', 'で', 'ね', '言う', 'ない', 'で', 'ね']
今更なんて 言わないでね | ['今更', 'なんて', '言う', 'ない', 'で', 'ね']
僕ら今 さあさあ輪になって 回り始める | ['僕ら', '今', 'さあ', 'さあ', '輪', 'に', 'なる', 'て', '回る', '始める']
段々嫌になって でも好きになる | ['段々', '嫌', 'に', 'なる', 'て', 'でも', '好き', 'に', 'なる']
ねえねえ わかんないや 自分会議も | ['ねえ', 'ねえ', 'わく', 'ん', 'な', 'いや', '自分', '会議', 'も']
どんどん 中に寄って でも離れてく | ['どんどん', '中', 'に', '寄る', 'て', 'でも', '離れる', 'て', 'く']

76: Last Dance | Eve
ここに蔓延る摩天楼 | ['ここ', 'に', '蔓延る', '摩天楼']
君の確かな芽を摘んできた | ['君', 'の', '確か', 'だ', '芽', 'を', '摘む', 'で', 'くる', 'た']
叶えたいもの全て奪い攫っては | ['叶える', 'た', 'いも', 'の', '全て', '奪う', '攫う', 'て', 'は']
僕をねじ曲げてく | ['僕', 'を', 'ねじ曲げる', 'て', 'く']
価値観違い 嫌いなあいつは | ['価値', '観', '違い', '嫌い', 'だ', 'あいつ', 'は']
滑稽なんて嗤いあって | ['滑稽', 'なんて', '嗤', 'いる', 'あう', 'て']
上品な言葉 乗せあって待って焦って足掻いた | ['上品', 'だ', '言葉', '乗せる', 'あう', 'て', '待つ', 'て', '焦る', 'て', '足掻く', 'た']
せっせ 知恵を絞って せっせ 欲をかいて | ['せっせ', '知恵', 'を', '絞る', 'て', 'せっせ', '欲', 'を', 'かく', 'て']
エゴに堕ちてゆけ | ['エゴ', 'に', '堕ちる', 'て', 'ゆく']
あなたは言った 消耗品さ | ['あなた', 'は', '言う', 'た', '消耗', '品', 'さ']
だけど私は まだ考えてるわ | ['だけど', '私', 'は', 'まだ', '考える', 'てる', 'わ']
いつかまた こうやって | ['いつか', 'また', 'こう', 'やる', 'て']
踊ってやってくれないか | ['踊る', 'て', 'やる', 'て', 'くれる', 'ない', 'か']
辛気を纏った 少年少女 | ['辛気', 'を', '纏う', 'た', '少年', '少女']
憂さを晴らした イエスマン患者 | ['憂さ', 'を', '晴らす', 'た', 'イエス', 'マン', '患者']
誰も何者でもないもの | ['誰', 'も', '何者', 'で', 'も', 'ない', 'もの']
真意を知れば最期になるならさ | ['真意', 'を', '知る', 'ば', '最期', 'に', 'なる', 'だ', 'さ']
舌が乾くまで話そうぜ | ['舌', 'が', '乾く', 'まで', '話す', 'う', 'ぜ']

77: Ao No Waltz | Eve
懐かしさに溺れた まだ青かった僕ら | ['懐かしい', 'さ', 'に', '溺れる', 'た', 'まだ', '青い', 'た', '僕ら']
雲が残る合間 ただ太陽を見ていた | ['雲', 'が', '残る', '合間', 'ただ', '太陽', 'を', '見る', 'て', 'いる', 'た']
おざなりな僕ら 溢れ出した声が | ['お', 'ざなりな', '僕ら', '溢れる', '出す', 'た', '声', 'が']
ただ大切なことは 伝わらないようにできてた | ['ただ', '大切', 'だ', 'こと', 'は', '伝わる', 'ない', 'よう', 'に', 'できる', 'てる', 'た']
かたちのない色味を 抱きしめてみたの | ['かたち', 'の', 'ない', '色', '味', 'を', '抱きしめる', 'て', 'みる', 'た', 'の']
期待と不安の日々を 後悔の味で知った | ['期待', 'と', '不安', 'の', '日々', 'を', '後悔', 'の', '味', 'で', '知る', 'た']
知らない世界へ 手を伸ばしたくて | ['知る', 'ない', '世界', 'へ', '手', 'を', '伸ばす', 'たい', 'て']
強がりの空を ポケットにしまった | ['強がる', 'の', '空', 'を', 'ポケット', 'に', 'しまう', 'た']
優しさを包む痛みも全部 | ['優しい', 'さ', 'を', '包む', '痛み', 'も', '全部']
覚えていたくて | ['覚える', 'て', 'いる', 'たい', 'て']
ただ願って願って 生まれ変わっても | ['ただ', '願う', 'て', '願う', 'て', '生まれ変わる', 'て', 'も']

78: ラブ・ドラマティック | Masayuki Suzuki
Oh love me | ['Oh', 'love', 'm', 'e']
Mister oh mister | ['Mister', 'o', 'h', 'mister']
夢じゃないなら聴かせて | ['夢', 'じゃ', 'ない', 'だ', '聴く', 'せる', 'て']
ねえ mister もうmister | ['ねえ', 'mister', 'もう', 'mister']
焦らされるほど切ない | ['焦らす', 'れる', 'ほど', '切ない']
想いだけが暴れだす | ['想い', 'だけ', 'が', '暴れだす']
その視線に負けそうになる | ['その', '視線', 'に', '負ける', 'そう', 'に', 'なる']
ふたりだけの 危ないgame | ['ふたり', 'だけ', 'の', '危ない', 'game']
Love is war | ['Love', 'i', 's', 'war']
Love is war | ['Love', 'i', 's', 'war']
Love is war | ['Love', 'i', 's', 'war']
踊らせて ドラマティックはこれから | ['踊る', 'せる', 'て', 'ドラマティック', 'は', 'これから']
いじわるな恋の予感 しびれる | ['いじわる', 'だ', '恋', 'の', '予感', 'しびれる']
触れた指の先が運命を待ちわびている | ['触れる', 'た', '指', 'の', '先', 'が', '運命', 'を', '待ちわびる', 'て', 'いる']
あなたに言わせたい | ['あなた', 'に', '言う', 'せる', 'たい']
心の壁を | ['心', 'の', '壁', 'を']
やぶる愛の告白 | ['やぶる', '愛', 'の', '告白']
Oh love me | ['Oh', 'love', 'm', 'e']
Mister oh mister | ['Mister', 'o', 'h', 'mister']
夢じゃないなら聴かせて | ['夢', 'じゃ', 'ない', 'だ', '聴く', 'せる', 'て']
ねえ mister もう mister | ['ねえ', 'mister', 'もう', 'mister']
焦らされるほど切ない | ['焦らす', 'れる', 'ほど', '切ない']

79: Sing | Goose house
どんなに考えたって | ['どんなに', '考える', 'た', 'って']
答えが出てくるわけでもないし | ['答え', 'が', '出る', 'て', 'くる', 'わけ', 'だ', 'も', 'ない', 'し']
青に包まれた朝は | ['青', 'に', '包む', 'れる', 'た', '朝', 'は']
昨日の僕にどこか似ていた | ['昨日', 'の', '僕', 'に', 'どこ', 'か', '似る', 'て', 'いる', 'た']
何かトクベツなことを | ['何', 'か', 'トクベツ', 'だ', 'こと', 'を']
毎日探すのは疲れちゃうし | ['毎日', '探す', 'の', 'は', '疲れる', 'ちゃう', 'し']
だからって何もないのは | ['だから', 'って', '何', 'も', 'ない', 'の', 'は']
イヤなんだからワガママだよね | ['イヤ', 'だ', 'ん', 'だ', 'から', 'ワガママ', 'だ', 'よ', 'ね']
世の中は溢れてる | ['世の中', 'は', '溢れる', 'てる']
さみしいとかうれしいとか | ['さみしい', 'とか', 'うれしい', 'とか']
そこに色がついたら | ['そこ', 'に', '色', 'が', 'つく', 'た']
何か変わるかな | ['何', 'か', '変わる', 'か', 'な']
僕らはまだ不完全で | ['僕ら', 'は', 'まだ', '不完全', 'だ']
もろくてちっぽけな音だけれど | ['もろい', 'て', 'ちっぽけ', 'だ', '音', 'だ', 'けれど']
このウタは届くかな | ['この', 'ウタ', 'は', '届く', 'か', 'な']
この空の片隅で | ['この', '空', 'の', '片隅', 'で']
Let's sing a song | ['Let', "'", 's', 'sing', 'a', 'song']

80: 君のせい | the peggies
君のせい 君のせい 君のせいで私 | ['君', 'の', 'せい', '君', 'の', 'せい', '君', 'の', 'せい', 'で', '私']
臆病でかっこつかない | ['臆病', 'で', 'かっこ', 'つく', 'ない']
君のせいだよ | ['君', 'の', 'せい', 'だ', 'よ']
少し伸びた前髪に隠れてる君の目 | ['少し', '伸びる', 'た', '前髪', 'に', '隠れる', 'てる', '君', 'の', '目']
ちょっとどこ見てんの？こっちに来て！ | ['ちょっと', 'どこ', '見る', 'て', 'ん', 'の', '?', 'こっち', 'に', '来る', 'て', '!']
君が私を夢中にさせるのに難しい事は一つもない | ['君', 'が', '私', 'を', '夢中', 'に', 'する', 'せる', 'のに', '難しい', '事', 'は', '一つ', 'も', 'ない']
夕方の駅のホーム 波の音 | ['夕方', 'の', '駅', 'の', 'ホーム', '波', 'の', '音']
黙る私を見透かしたように | ['黙る', '私', 'を', '見透かす', 'た', 'よう', 'に']
そんな風に笑わないで | ['そんな', '風', 'に', '笑う', 'ない', 'で']
君のせい 君のせい 君のせいで私 | ['君', 'の', 'せい', '君', 'の', 'せい', '君', 'の', 'せい', 'で', '私']
臆病でかっこつかない | ['臆病', 'で', 'かっこ', 'つく', 'ない']
こんなはずじゃないのに | ['こんな', 'はず', 'じゃ', 'ない', 'のに']
君のせい 君のせい 君のせいで私 | ['君', 'の', 'せい', '君', 'の', 'せい', '君', 'の', 'せい', 'で', '私']

81: 色彩 | yama
じっと機微を見逃さないで | ['じっと', '機微', 'を', '見逃す', 'ない', 'で']
きっと大人はそれらしくするのでかかりきりになるんだ | ['きっと', '大人', 'は', 'それ', 'らしい', 'する', 'ので', 'かかる', 'きり', 'に', 'なる', 'ん', 'だ']
関心はまだ僕ら | ['関心', 'は', 'まだ', '僕ら']
真珠の欠片だって無価値 そこに物語がなければ | ['真珠', 'の', '欠片', 'だって', '無', '価値', 'そこ', 'に', '物語', 'が', 'ない', 'ば']
からくりのなかで廻る僕ら命だ | ['からくり', 'の', 'なか', 'で', '廻る', '僕ら', '命', 'だ']
実は奇跡のような毎日を 当たり前に手を差し伸べあって過ごしている | ['実は', '奇跡', 'の', 'よう', 'だ', '毎日', 'を', '当たり前', 'に', '手', 'を', '差し伸べる', 'あう', 'て', '過ごす', 'て', 'いる']
心あたたかであること 笑うほど寂しいことはないでしょう? | ['心', 'あたたかい', 'だ', 'ある', 'こと', '笑う', 'ほど', '寂しい', 'こと', 'は', 'ない', 'です', 'う', '?']
落ち込む夜でさえ多彩で気まぐれなように | ['落ち込む', '夜', 'で', 'さえ', '多彩', 'だ', '気まぐれ', 'だ', 'よう', 'に']
どの人生も悪くはないだろう | ['どの', '人生', 'も', '悪い', 'は', 'ない', 'だ', 'う']
強がる事を知れど今までの | ['強がる', '事', 'を', '知れる', 'ど', '今', 'まで', 'の']
足跡や産まれたことは消えやしない | ['足跡', 'や', '産まれる', 'た', 'こと', 'は', '消える', 'やす', 'ない']
軽い冗談で傷がついてしまう | ['軽い', '冗談', 'で', '傷', 'が', 'つく', 'て', 'しまう']
柔らかなままでいい そのままでいい | ['柔らか', 'だ', 'まま', 'だ', 'いい', 'そのまま', 'だ', 'いい']

82: SOUVENIR | BUMP OF CHICKEN
恐らく気付いてしまったみたい | ['恐らく', '気付く', 'て', 'しまう', 'た', 'みたい']
あくびの色した毎日を | ['あくび', 'の', '色', 'する', 'た', '毎日', 'を']
丸ごと映画の様に変える | ['丸ごと', '映画', 'の', '様', 'に', '変える']
種と仕掛けに出会えた事 | ['種', 'と', '仕掛け', 'に', '出会える', 'た', '事']
仲良くなれない空の下 | ['仲良く', 'なれる', 'ない', '空', 'の', '下']
心はしまって鍵かけて | ['心', 'は', 'しまう', 'て', '鍵', 'かける', 'て']
そんな風にどうにか生きてきた | ['そんな', '風', 'に', 'どうにか', '生きる', 'て', 'くる', 'た']
メロディが重なった | ['メロディ', 'が', '重なる', 'た']
小さくたっていい | ['小さい', 'たつ', 'て', 'いい']
街のどんな灯よりも | ['街', 'の', 'どんな', '灯', 'より', 'も']
ちゃんと見つけられる | ['ちゃんと', '見つける', 'られる']
目印が欲しかった | ['目印', 'が', '欲しい', 'た']
この目が選んだ景色に | ['この', '目', 'が', '選ぶ', 'だ', '景色', 'に']
ひとつずつリボンかけて | ['ひとつ', 'ずつ', 'リボン', 'かける', 'て']
お土産みたいに集めながら続くよ 帰り道 | ['お', '土産', 'みたい', 'に', '集める', 'ながら', '続く', 'よ', '帰り道']
季節が挨拶くれたよ | ['季節', 'が', '挨拶', 'くれる', 'た', 'よ']

83: YELLOW | Yoh kamiyama
つまりは好奇心に囚われてたんだ | ['つまり', 'は', '好奇', '心', 'に', '囚われる', 'てる', 'た', 'ん', 'だ']
大切なものなら壊したんだ | ['大切', 'だ', 'もの', 'だ', '壊す', 'た', 'ん', 'だ']
明かりの灯がないホールケーキ | ['明かり', 'の', '灯', 'が', 'ない', 'ホール', 'ケーキ']
木製の君と踊ってたんだ | ['木製', 'の', '君', 'と', '踊る', 'てる', 'た', 'ん', 'だ']
クローゼットで待った今日は | ['クローゼット', 'で', '待つ', 'た', '今日', 'は']
小さな体ただ寄せ合って | ['小さな', '体', 'ただ', '寄せる', '合う', 'て']
眠るのさ、変わるのさ | ['眠る', 'の', 'さ', '、', '変わる', 'の', 'さ']
想像容易い安全 | ['想像', '容易い', '安全']
「私馬鹿な子どこにも行かないで」 | ['「', '私', '馬鹿', 'だ', '子', 'どこ', 'に', 'も', '行く', 'ない', 'で', '」']
重たい正体は鈍い目を覚ませ | ['重たい', '正体', 'は', '鈍い', '目', 'を', '覚ませる']
夜のうちが片付けたおもちゃ | ['夜', 'の', 'うち', 'が', '片付ける', 'た', 'おもちゃ']
無邪気なままでまだいたかった | ['無邪気', 'だ', 'まま', 'で', 'まだ', 'いたい', 'た']
愛情は HIGH ただ捨て置くばっかり | ['愛情', 'は', 'HIGH', 'ただ', '捨て置く', 'ばっかり']

84: takt | ryo (supercell)
あの街向かった僕ら | ['あの', '街', '向かう', 'た', '僕ら']
でたらめな歌を歌い | ['でたらめ', 'だ', '歌', 'を', '歌う']
「なんだよ、それ」って笑う | ['「', 'なん', 'だ', 'よ', '、', 'それ', '」', 'って', '笑う']
旅は続くと思った | ['旅', 'は', '続く', 'と', '思う', 'た']
悲しみが続く道を | ['悲しみ', 'が', '続く', '道', 'を']
あとどれだけ歩けばいい？ | ['あと', 'どれ', 'だけ', '歩く', 'ば', 'いい', '?']
振り返ってももう見えない | ['振り返る', 'て', 'も', 'もう', '見える', 'ない']
輝くのは過ぎた日 | ['輝く', 'の', 'は', '過ぎる', 'た', '日']
同じ時 思い出して弾くよ 弾くよ 弾くよ | ['同じ', '時', '思い出す', 'て', '弾く', 'よ', '弾く', 'よ', '弾く', 'よ']
ほら 君と見上げてた流れ星 | ['ほら', '君', 'と', '見上げる', 'てる', 'た', '流れ星']
連れていこう あの歌を | ['連れる', 'て', 'いく', 'う', 'あの', '歌', 'を']
あの時を あの夜を | ['あの', '時', 'を', 'あの', '夜', 'を']
僕らがいる いつでも逢える | ['僕ら', 'が', 'いる', 'いつ', 'でも', '逢える']
寂しくないよ そこにいるから | ['寂しい', 'ない', 'よ', 'そこ', 'に', 'いる', 'から']
忘れはしない 響け | ['忘れ', 'は', 'する', 'ない', '響く']
この懐かしい旋律が | ['この', '懐かしい', '旋律', 'が']

85: ラグトレイン | 稲葉曇
離れ離れの街を繋ぐ列車は行ってしまったね | ['離れ離れ', 'の', '街', 'を', '繋ぐ', '列車', 'は', '行う', 'て', 'しまう', 'た', 'ね']
失くした言葉を知らないなら | ['失', 'くい', 'た', '言葉', 'を', '知る', 'ない', 'だ']
ポケットで握りしめて | ['ポケット', 'で', '握りしめる', 'て']
あがいた息を捨てて延びる今日は眠って誤魔化せ | ['あがく', 'た', '息', 'を', '捨てる', 'て', '延びる', '今日', 'は', '眠る', 'て', '誤魔化す']
失くした言葉を知らないなら | ['失', 'くい', 'た', '言葉', 'を', '知る', 'ない', 'だ']
各駅停車に乗り込んで | ['各駅', '停車', 'に', '乗り込む', 'で']
夕方と退屈のお誘いを断って | ['夕方', 'と', '退屈', 'の', 'お誘い', 'を', '断る', 'て']
一人きり | ['一', '人', 'きり']
路地裏は決して急がないで | ['路地', '裏', 'は', '決して', '急ぐ', 'ない', 'で']
ほら 横断歩道も待ってくれと言ってる | ['ほら', '横断', '歩道', 'も', '待つ', 'て', 'くれる', 'と', '言う', 'てる']
見張る街角があなたを引き留めてく | ['見張る', '街角', 'が', 'あなた', 'を', '引き留める', 'て', 'く']
離れ離れの街を繋ぐ列車は行ってしまったね | ['離れ離れ', 'の', '街', 'を', '繋ぐ', '列車', 'は', '行う', 'て', 'しまう', 'た', 'ね']

86: Liar Mask | 真山りか
朽ち果てるように燃ゆる月 | ['朽ち果てる', 'よう', 'に', '燃', 'ゆる', '月']
暁に沈みゆく | ['暁', 'に', '沈む', 'ゆく']
造られた仮面(かお)で そっと近付いて | ['造る', 'れる', 'た', '仮面', '(', 'かお', ')', 'で', 'そっと', '近付く', 'て']
信じるモノを 闇に落とす | ['信じる', 'モノ', 'を', '闇', 'に', '落とす']
糸に絡まる エモノのように | ['糸', 'に', '絡まる', 'エモノ', 'の', 'よう', 'に']
ただ ひたすらに 空を仰ぐ | ['ただ', 'ひたすら', 'に', '空', 'を', '仰ぐ']
繰り返される悲劇 不気味に笑う裏の顔 | ['繰り返す', 'れる', '悲劇', '不気味', 'に', '笑う', '裏', 'の', '顔']
これ以上 何ひとつ 失くさないように刀を抜く | ['これ', '以上', '何', 'ひとつ', '失', 'くさい', 'ない', 'よう', 'に', '刀', 'を', '抜く']
闇に葬れ 汚れた笑顔 | ['闇', 'に', '葬れる', '汚れる', 'た', '笑顔']
やり場のない怒り、放て! | ['やり場', 'の', 'ない', '怒り', '、', '放つ', '!']
どれだけの血と涙を流したら... | ['どれ', 'だけ', 'の', '血', 'と', '涙', 'を', '流す', 'た', '.', '.', '.']
祈るように斬り裂いて | ['祈る', 'よう', 'に', '斬る', '裂く', 'て']
今日もアカク染め上げよ! | ['今日', 'も', 'アカク', '染め上げる', '!']

None type
88: SPARK-AGAIN | Aimer
失くしたものばかり | ['失', 'くい', 'た', 'もの', 'ばかり']
殘したこの火種は離さない | ['殘', 'する', 'た', 'この', '火種', 'は', '離す', 'ない']
離さないから ずっと | ['離す', 'ない', 'から', 'ずっと']
曖昧 物語 正解なんてなくたって | ['曖昧', '物語', '正解', 'なんて', 'ない', 'たって']
踏み出すようになれたら | ['踏み出す', 'よう', 'に', 'なれる', 'た']
「どうかしてる」って言うけど どうにかしてあげるよ | ['「', 'どう', 'かす', 'てる', '」', 'って', '言う', 'けど', 'どうにか', 'する', 'て', 'あげる', 'よ']
どうなったらいいかさえ わからなくなるけど | ['どう', 'なる', 'た', 'いい', 'か', 'さえ', 'わかる', 'ない', 'なる', 'けど']
夢がその隣で覚悟を決めたなら | ['夢', 'が', 'その', '隣', 'で', '覚悟', 'を', '決める', 'た', 'だ']
疑うものなんて何もなくなるから | ['疑う', 'もの', 'なんて', '何', 'も', 'なくなる', 'から']
火花散って 火蓋切って 白か黒も灰にかえるまで | ['火花', '散る', 'て', '火蓋', '切る', 'て', '白', 'か', '黒', 'も', '灰', 'に', 'かえる', 'まで']
とびきりの王冠なら手に入れたい 手に入れたい | ['とびきり', 'の', '王冠', 'だ', '手', 'に', '入れる', 'たい', '手', 'に', '入れる', 'たい']
風を切って 君のほうへ 1か8か0に変えるまで | ['風', 'を', '切る', 'て', '君', 'の', 'ほう', 'へ', '1', 'か', '8', 'か', '0', 'に', '変える', 'まで']
ふさぎ込んだ道化師なら 森羅万象 はじまんないよ | ['ふさぎ込む', 'だ', '道化師', 'だ', '森羅万象', 'は', 'じまん', 'ない', 'よ']
灰も焦がすよな愛をみせるから | ['灰', 'も', '焦がす', 'よ', 'だ', '愛', 'を', 'みせる', 'から']

89: Torch of Liberty | KANA-BOON
Fly & fire | ['Fly', '&', 'fire']
帰す快晴 救済唱歌 | ['帰す', '快晴', '救済', '唱歌']
あぶれた声 慈愛を | ['あぶれる', 'た', '声', '慈愛', 'を']
はみ出したって未来を | ['はみ出す', 'た', 'って', '未来', 'を']
Get back 再生 yeah | ['Get', 'back', '再生', 'yeah']
四苦八苦 無い方へ | ['四苦八苦', '無い', '方', 'へ']
曇天に隠れて太陽 | ['曇天', 'に', '隠れる', 'て', '太陽']
風よ闇を攫って | ['風', 'よ', '闇', 'を', '攫う', 'て']
遊覧船 待って 泣いて憂う | ['遊覧', '船', '待つ', 'て', '泣く', 'て', '憂う']
揺らせ まだ夕景 そう笑って | ['揺らせる', 'まだ', '夕景', 'そう', '笑う', 'て']
腫れて爛れて 待ってるがまだ夢 | ['腫れる', 'て', '爛れる', 'て', '待つ', 'てる', 'が', 'まだ', '夢']

None type
91: BAKU | Ikimonogakari
なんども僕らは 夢に魅せられて | ['なんど', 'も', '僕ら', 'は', '夢', 'に', '魅せる', 'られる', 'て']
熱い息を乱して 駆け出すの | ['熱い', '息', 'を', '乱す', 'て', '駆け出す', 'の']
どこまでいけるか 果てまで見たくて | ['どこ', 'まで', 'いける', 'か', '果て', 'まで', '見る', 'たい', 'て']
新しい空に告ぐ | ['新しい', '空', 'に', '告ぐ']
カクゴハイイデショウカ | ['カクゴハイイデショウカ']
ヨアケハコレカラ | ['ヨアケハコレカラ']
こころ 喰らうのは 未来だけ | ['こころ', '喰らう', 'の', 'は', '未来', 'だけ']
感情揺らしていいじゃん | ['感情', '揺らす', 'て', 'いい', 'じゃん']
怒りを愛に混ぜて | ['怒り', 'を', '愛', 'に', '混ぜる', 'て']
ゼロかイチじゃないんだ | ['ゼロ', 'か', 'イチ', 'じゃ', 'ない', 'ん', 'だ']
混沌で僕らは生きてる | ['混沌', 'で', '僕ら', 'は', '生きる', 'てる']
正解に溺れた世界で | ['正解', 'に', '溺れる', 'た', '世界', 'で']
キミは自分に問いかける | ['キミ', 'は', '自分', 'に', '問いかける']
ホントウニ タノシイノ | ['ホント', 'ウニ', 'タノシイノ']
胸がざわめくよ | ['胸', 'が', 'ざわめく', 'よ']
なんども僕らは 壊したくなるの | ['なんど', 'も', '僕ら', 'は', '壊す', 'たい', 'なる', 'の']
もう渇いた大地に夢はない | ['もう', '渇く', 'た', '大地', 'に', '夢', 'は', 'ない']

92: 勘冴えて悔しいわ | ZUTOMAYO
「君のことじゃないよ」 | ['「', '君', 'の', 'こと', 'じゃ', 'ない', 'よ', '」']
気のせいにしたいよ | ['気', 'の', 'せい', 'に', 'する', 'たい', 'よ']
ばれたって誤魔化すの | ['ばれる', 'た', 'って', '誤魔化す', 'の']
相手にしないで | ['相手', 'に', 'する', 'ない', 'で']
背の順あいうえお | ['背', 'の', '順', 'あく', 'う', 'え', 'お']
並びたくもないよ | ['並ぶ', 'たい', 'も', 'ない', 'よ']
もういっそ お目出度い 一人を竹刀で | ['もう', 'いっそ', 'お', '目出度い', '一', '人', 'を', '竹刀', 'で']
誰かといないと | ['誰', 'か', 'と', 'いる', 'ない', 'と']
避難場所はないよ | ['避難', '場所', 'は', 'ない', 'よ']
ミラクルな目を | ['ミラクル', 'だ', '目', 'を']
まだ逸らせはしないで | ['まだ', '逸らせる', 'は', 'する', 'ない', 'で']
あたしを嫌う鳥の | ['あたし', 'を', '嫌う', '鳥', 'の']
笑い声を消そうよ | ['笑い声', 'を', '消す', 'う', 'よ']
端ないほど集中力が | ['端', 'ない', 'ほど', '集中', '力', 'が']
着いた 吐いた ツイッター呟く | ['着く', 'た', '吐く', 'た', 'ツイッター', '呟く']
7個目の方で | ['7', '個', '目', 'の', '方', 'だ']
ATP上手に受け渡す日々だけ | ['ATP', '上手', 'に', '受ける', '渡す', '日々', 'だけ']
もう 勘が冴えて悔しいわ | ['もう', '勘', 'が', '冴える', 'て', '悔しい', 'わ']
無意識に運べたら楽だろうな | ['無意識', 'に', '運べる', 'た', '楽', 'だ', 'う', 'な']
淡々と笑えないわ | ['淡々', 'と', '笑える', 'ない', 'わ']
取り繕ってしまうわ | ['取り繕う', 'て', 'しまう', 'わ']
いつも | ['いつも']
ゲラゲラ 道を塞ぐ民よ | ['ゲラゲラ', '道', 'を', '塞ぐ', '民', 'よ']
感謝の言葉しか出てこないよ | ['感謝', 'の', '言葉', 'しか', '出る', 'て', 'くる', 'ない', 'よ']
後戻りは しなくていいの | ['後戻り', 'は', 'する', 'ない', 'て', 'いい', 'の']

93: お勉強しといてよ | ZUTOMAYO
質のいい病み感情が 溢れた時の | ['質', 'の', 'いい', '病む', '感情', 'が', '溢れる', 'た', '時', 'の']
しょうがないって言葉は 照れくさい oh | ['しょうが', 'ない', 'って', '言葉', 'は', '照れくさい', 'o', 'h']
想像力が無限大 魅力的なので | ['想像', '力', 'が', '無限', '大', '魅力', '的', 'だ', 'ので']
意味わかんない言葉にも 期待していい | ['意味', 'わかる', 'ない', '言葉', 'に', 'も', '期待', 'する', 'て', 'いい']
昨日の思い出 お洗濯したって 相変わらず | ['昨日', 'の', '思い出', 'お', '洗濯', 'する', 'た', 'って', '相変わらず']
乾かないや 寒がりな季節に | ['乾く', 'ない', 'や', '寒い', 'がる', 'だ', '季節', 'に']
あぁ 勿体ぶっていいから このまんま | ['あぁ', '勿体ぶる', 'て', 'いい', 'から', 'この', 'まんま']
焼き焼きだ 押し潰される無敵め | ['焼き', '焼き', 'だ', '押す', '潰す', 'れる', '無敵', 'め']
褒めあいライム 合図 変わらず | ['褒める', 'あう', 'ライム', '合図', '変わる', 'ぬ']
乾かないや 強がりな季節に | ['乾く', 'ない', 'や', '強がる', 'だ', '季節', 'に']
あぁ 勿体ぶっていいから 孤のまんま | ['あぁ', '勿体ぶる', 'て', 'いい', 'から', '孤', 'の', 'まんま']
ヤンキーヤンキーだ 現状維持の無敵め ohoh | ['ヤンキー', 'ヤンキー', 'だ', '現状', '維持', 'の', '無敵', 'め', 'ohoh']
ファンキーな直感で 今日の歌だって 変わってゆくなら | ['ファンキー', 'だ', '直感', 'で', '今日', 'の', '歌', 'だって', '変わる', 'て', 'ゆく', 'だ']
そんな理由で 飛び込んでみたいけど | ['そんな', '理由', 'で', '飛び込む', 'で', 'みる', 'たい', 'けど']
ただ泣きたくて、謀っといて 集めちゃった感情参考書です | ['ただ', '泣く', 'たい', 'て', '、', '謀る', 'とく', 'て', '集める', 'ちゃう', 'た', '感情', '参考', '書', 'です']
お勉強しといてよ 解いといてよ | ['お', '勉強', 'する', 'とく', 'て', 'よ', '解く', 'とく', 'て', 'よ']
今日どうしよ？も | ['今日', 'どうし', 'よ', '?', 'も']

94: 空と虚 | sasanomaly
単純 大体 喜怒哀 love? 君の考え事 | ['単純', '大体', '喜怒', '哀', 'love', '?', '君', 'の', '考え事']
いつかわかるときがくるといいね | ['いつか', 'わかる', 'とき', 'が', 'くる', 'と', 'いい', 'ね']
何度だって切った貼ったで ツギハギ もう無惨だね | ['何', '度', 'だって', '切る', 'た', '貼る', 'た', 'で', 'ツギ', 'ハギ', 'もう', '無惨', 'だ', 'ね']
「生きてる」の定義もわからないまま | ['「', '生きる', 'てる', '」', 'の', '定義', 'も', 'わかる', 'ない', 'まま']
ただ 二人だけで とかは 言わなくてもいい | ['ただ', '二', '人', 'だけ', 'で', 'とか', 'は', '言う', 'ない', 'て', 'も', 'いい']
解り合ってゆける 気がするだけどまだ それでいいじゃん | ['解る', '合う', 'て', 'ゆける', '気', 'が', 'する', 'だ', 'けど', 'まだ', 'それ', 'で', 'いう', 'じゃん']
大好きな世界 君だけがくれる光で | ['大好き', 'だ', '世界', '君', 'だけ', 'が', 'くれる', '光', 'で']
ひび割れたこの目が触れてる世界は | ['ひび割れる', 'た', 'この', '目', 'が', '触れる', 'てる', '世界', 'は']
すべてがほら 輝くようで | ['すべて', 'が', 'ほら', '輝く', 'よう', 'だ']
確かなものなど無いけど | ['確か', 'だ', 'もの', 'など', '無い', 'けど']
その目に僕は見えるでしょう？ | ['その', '目', 'に', '僕', 'は', '見える', 'です', 'う', '?']

95: missing | Ado
いつか どこか 何だって | ['いつか', 'どこ', 'か', '何', 'だって']
欲しい情報求ム 皆無 | ['欲しい', '情報', '求', 'ム', '皆無']
正体を掴みたいあいつは | ['正体', 'を', '掴む', 'たい', 'あいつ', 'は']
きっと地獄か天国のスパイ | ['きっと', '地獄', 'か', '天国', 'の', 'スパイ']
さあ問題見付かっちゃった | ['さあ', '問題', '見付かる', 'ちゃう', 'た']
果たしてどっちの依頼？ | ['果たして', 'どっち', 'の', '依頼', '?']
いや有害か有益かは | ['いや', '有害', 'か', '有益', 'か', 'は']
一旦置いておこうどっこいどっこい | ['一旦', '置く', 'て', 'おく', 'う', 'どっこいどっこい']
あたし リア充ながらバーチュアル？ | ['あたし', 'リア', '充', 'ながら', 'バーチュアル', '?']
雨晒し ずぶ濡れの純情み あざとい？ | ['雨', '晒し', 'ずぶ濡れ', 'の', '純情', 'みる', 'あざとい', '?']

None type
97: Bad example | たかやん
罵られたって ウザイ日だって | ['罵る', 'れる', 'た', 'って', 'ウザイ', '日', 'だって']
もしフラれたって この世は回るよ | ['もし', 'フラ', 'れる', 'た', 'って', 'この世', 'は', '回る', 'よ']
引かれたって 見捨てられたって | ['引く', 'れる', 'た', 'って', '見捨てる', 'られる', 'た', 'って']
いいんじゃないかい？ 今が楽しいけれどさ | ['いい', 'ん', 'じゃ', 'ない', 'かい', '?', '今', 'が', '楽しい', 'けれど', 'さ']
不貞腐れたっていい！ 本音話せばいい！ | ['不貞腐れる', 'たつ', 'て', 'いい', '!', '本音', '話す', 'ば', 'いい', '!']
結果、人生の全部はどうでもいいから！ | ['結果', '、', '人生', 'の', '全部', 'は', 'どう', 'でも', 'いい', 'から', '!']
笑顔にさせる 夢を持たせる | ['笑顔', 'に', 'する', 'せる', '夢', 'を', '持つ', 'せる']
だって本当は生き足りないんじゃない？ | ['だって', '本当は', '生きる', '足りる', 'ない', 'ん', 'じゃ', 'ない', '?']
人格否定されて | ['人格', '否定', 'する', 'れる', 'て']

98: specialist | アトラスサウンドチーム

99: KICK BACK | Kenshi Yonezu
努力 未来 a beautiful star | ['努力', '未来', 'a', 'beautiful', 'star']
努力 未来 a beautiful star | ['努力', '未来', 'a', 'beautiful', 'star']
努力 未来 a beautiful star | ['努力', '未来', 'a', 'beautiful', 'star']
努力 未来 a beautiful star | ['努力', '未来', 'a', 'beautiful', 'star']
ランドリー今日はガラ空きでラッキーデイ | ['ランドリー', '今日', 'は', 'ガラ', '空き', 'で', 'ラッキーデイ']
かったりい油汚れもこれでバイバイ | ['かる', 'たり', 'いる', '油', '汚れ', 'も', 'これ', 'で', 'バイバイ']
誰だ誰だ頭の中 呼びかける声は | ['誰', 'だ', '誰', 'だ', '頭', 'の', '中', '呼びかける', '声', 'は']
あれが欲しいこれが欲しいと歌っている | ['あれ', 'が', '欲しい', 'これ', 'が', '欲しい', 'と', '歌う', 'て', 'いる']
幸せになりたい 楽して生きていたい | ['幸せ', 'に', 'なる', 'たい', '楽しい', 'て', '生きる', 'て', 'いる', 'たい']
この手に掴みたい あなたのその胸の中 | ['この', '手', 'に', '掴む', 'たい', 'あなた', 'の', 'その', '胸', 'の', '中']
ハッピーで埋め尽くして レストインピースまで行こうぜ | ['ハッピー', 'だ', '埋める', '尽くす', 'て', 'レストインピース', 'まで', '行く', 'う', 'ぜ']
いつかみた地獄もいいところ 愛をばら撒いて | ['いつか', 'みる', 'た', '地獄', 'も', 'いい', 'ところ', '愛', 'を', 'ばら', '撒く', 'て']
アイラブユー貶してくれ 全部奪って笑ってくれマイハニー | ['アイラブユー', '貶す', 'て', 'くれる', '全部', '奪う', 'て', '笑う', 'て', 'くれる', 'マイハニー']
努力 未来 a beautiful star | ['努力', '未来', 'a', 'beautiful', 'star']
努力 未来 a beautiful star | ['努力', '未来', 'a', 'beautiful', 'star']

100: EgoもIdも単純に | THE BINARY
愛してよ | ['愛す', 'て', 'よ']
もっとエゴもイドも単純に | ['もっと', 'エゴ', 'も', 'イド', 'も', '単純', 'に']
逃げ込んだ非現実であなたは嘘をつく | ['逃げ込む', 'だ', '非', '現実', 'で', 'あなた', 'は', '嘘', 'を', 'つく']
私はだれなんて | ['私', 'は', 'だれ', 'なんて']
だれも答えないの | ['だれ', 'も', '答える', 'ない', 'の']
だから望むままにその目に映してる | ['だから', '望む', 'まま', 'に', 'その', '目', 'に', '映す', 'てる']
人間を象った私の姿を | ['人間', 'を', '象る', 'た', '私', 'の', '姿', 'を']
夢や理想をなぞる | ['夢', 'や', '理想', 'を', 'なぞる']
それが幸せなら | ['それ', 'が', '幸せ', 'だ']
すべてを塗り潰し新たに描きましょう | ['すべて', 'を', '塗り潰す', '新た', 'に', '描く', 'ます', 'う']
いつしか剥離した自分が笑い掛ける | ['いつしか', '剥離', 'する', 'た', '自分', 'が', '笑う', '掛ける']
その声も感情も 気付けば奪われ | ['その', '声', 'も', '感情', 'も', '気付く', 'ば', '奪う', 'れる']
画面の向こうの佞言に溺れる | ['画面', 'の', '向こう', 'の', '佞言', 'に', '溺れる']
教えて | ['教える', 'て']
本当の私はそこにいるの | ['本当', 'の', '私', 'は', 'そこ', 'に', 'いる', 'の']
仮面の下を這いずる心は | ['仮面', 'の', '下', 'を', '這いずる', '心', 'は']
ああただ惨めに崩れてくだけ | ['ああ', 'ただ', '惨め', 'に', '崩れる', 'て', 'く', 'だけ']
愛してよ | ['愛す', 'て', 'よ']
もっとエゴもイドも単純に | ['もっと', 'エゴ', 'も', 'イド', 'も', '単純', 'に']
この感情を暴き出して突き刺してくれよ | ['この', '感情', 'を', '暴き出す', 'て', '突き刺す', 'て', 'くれる', 'よ']
デタラメな明日に縋りながら | ['デタラメ', 'だ', '明日', 'に', '縋る', 'ながら']

101: 残酷な天使のテーゼ | Yoko Takahashi
残酷な天使のように | ['残酷', 'だ', '天使', 'の', 'よう', 'に']
少年よ 神話になれ | ['少年', 'よ', '神話', 'に', 'なる']
蒼い風がいま 胸のドアを叩いても | ['蒼い', '風', 'が', 'いま', '胸', 'の', 'ドア', 'を', '叩く', 'て', 'も']
私だけをただ見つめて | ['私', 'だけ', 'を', 'ただ', '見つめる', 'て']
微笑んでるあなた | ['微笑む', 'でる', 'あなた']
そっとふれるもの もとめることに夢中で | ['そっと', 'ふれる', 'もの', 'もとめる', 'こと', 'に', '夢中', 'だ']
運命さえまだ知らない いたいけな瞳 | ['運命', 'さえ', 'まだ', '知る', 'ない', 'いたいけ', 'だ', '瞳']
だけどいつか気付くでしょう その背中には | ['だけど', 'いつか', '気付く', 'です', 'う', 'その', '背中', 'に', 'は']
遥か未来 めざすための羽根があること | ['遥か', '未来', 'めざす', 'ため', 'の', '羽根', 'が', 'ある', 'こと']
残酷な天使のテーゼ | ['残酷', 'だ', '天使', 'の', 'テーゼ']
窓辺からやがて飛び立つ | ['窓辺', 'から', 'やがて', '飛び立つ']

102: wimp | BACK-ON
強がりの裏側に弱さを隠してた | ['強がる', 'の', '裏側', 'に', '弱い', 'さ', 'を', '隠す', 'てる', 'た']
逃げないよ、これからは、、、もう一度あの空へ！！ | ['逃げる', 'ない', 'よ', '、', 'これから', 'は', '、', '、', '、', 'もう一度', 'あの', '空', 'へ', '!', '!']
創り上げても壊して、また創って、何百回もAgain and again! | ['創る', '上げる', 'て', 'も', '壊す', 'て', '、', 'また', '創る', 'て', '、', '何', '百', '回', 'も', 'Again', 'and', 'again', '!']
でも負ける痛みに慣れ過ぎてた | ['でも', '負ける', '痛み', 'に', '慣れる', '過ぎる', 'てる', 'た']
認められたくて、空回って強がり見せた所で | ['認める', 'られる', 'たい', 'て', '、', '空', '回る', 'て', '強がる', '見せる', 'た', '所', 'で']
それじゃ、自分が虚しくなるだけじゃない？ | ['それ', 'じゃ', '、', '自分', 'が', '虚しい', 'なる', 'だけ', 'じゃ', 'ない', '?']
uh 行こうか！it's time to wake up! 目を醒ましな！強さは明確 | ['u', 'h', '行く', 'う', 'か', '!', 'it', "'", 's', 'time', 't', 'o', 'wake', 'up', '!', '目', 'を', '醒ます', 'な', '!', '強い', 'さ', 'は', '明確']
forget the fear and doubt you gotta burn it up | ['forget', 'the', 'fear', 'and', 'doubt', 'you', 'gotta', 'burn', 'i', 't', 'u', 'p']
一か八かさ！明日も不確か。 | ['一', 'か', '八', 'かさ', '!', '明日', 'も', '不確か', '。']
運命なんて壊せ Fight for yourself! 瞳(め)をそらすなFly again! | ['運命', 'なんて', '壊せる', 'Fight', 'for', 'yourself', '!', '瞳', '(', 'め', ')', 'を', 'そらす', 'な', 'Fly', 'again', '!']

103: レディメイド | Ado
ロンリー ロンリー | ['ロンリー', 'ロンリー']
寄る辺ない侘しさに | ['寄る辺', 'ない', '侘しい', 'さ', 'に']
頬杖ついてる | ['頬杖', 'ついてる']
ようじゃ変わらないわかってんだよ | ['よう', 'じゃ', '変わる', 'ない', 'わかる', 'て', 'ん', 'だ', 'よ']
Oh メイビー | ['Oh', 'メイビー']
ありふれたモブなんだって | ['ありふれる', 'た', 'モブ', 'だ', 'ん', 'だって']
認めてないならいっそ腐るまで叫んで | ['認める', 'て', 'ない', 'だ', 'いっそ', '腐る', 'まで', '叫ぶ', 'で']
異端傾けば？赤裸々に | ['異端', '傾く', 'ば', '?', '赤裸々', 'に']
本音ばかりじゃ生きられない | ['本音', 'ばかり', 'じゃ', '生きる', 'られる', 'ない']
路肩に寝転ぶ人生が | ['路肩', 'に', '寝転ぶ', '人生', 'が']
きっとお似合いだなあ | ['きっと', 'お似合い', 'だ', 'なあ']
大人になれば溶け込んで | ['大人', 'に', 'なる', 'ば', '溶け込む', 'で']
金と愛情で踊るのさ | ['金', 'と', '愛情', 'で', '踊る', 'の', 'さ']
One, two, three で弾け飛んだ | ['One', ',', 'two', ',', 'three', 'で', '弾ける', '飛ぶ', 'だ']
固定観念バットで打って | ['固定', '観念', 'バット', 'で', '打つ', 'て']
どうだい？どうだい？ | ['どう', 'だい', '?', 'どう', 'だい', '?']
楽ならまっいっか | ['楽', 'だ', 'まっ', 'いっか']
レディメイドの琴線に | ['レディ', 'メイド', 'の', '琴線', 'に']
歪みかけてノイズ混じり | ['歪み', 'かける', 'て', 'ノイズ', '混じり']
後悔？後悔？ | ['後悔', '?', '後悔', '?']
やめて黙っていろ | ['やめる', 'て', '黙る', 'て', 'いる']
舌に乗った | ['舌', 'に', '乗る', 'た']
苦い感情ばかりが発火して | ['苦い', '感情', 'ばかり', 'が', '発火', 'する', 'て']

104: フォニイ | ツミキ
この世で造花より | ['この世', 'で', '造花', 'より']
綺麗な花は無いわ | ['綺麗', 'だ', '花', 'は', '無い', 'わ']
何故ならば総ては嘘で出来ている | ['何故', 'だ', 'ば', '総て', 'は', '嘘', 'で', '出来る', 'て', 'いる']
Antipathy world | ['Antipathy', 'world']
絶望の雨はあたしの傘を突いて | ['絶望', 'の', '雨', 'は', 'あたし', 'の', '傘', 'を', '突く', 'て']
湿らす前髪とこころの裏面 | ['湿る', 'す', '前髪', 'と', 'こころ', 'の', '裏面']
煩わしいわ | ['煩わしい', 'わ']
何時しか言の葉は疾うに枯れきって | ['何時しか', '言の葉', 'は', '疾', 'うに', '枯れる', 'きる', 'て']
事の実があたしに熟れている | ['事', 'の', '実', 'が', 'あたし', 'に', '熟れる', 'て', 'いる']
鏡に映り嘘を描いて | ['鏡', 'に', '映る', '嘘', 'を', '描く', 'て']
自らを見失なった絵画 | ['自ら', 'を', '見る', '失', 'なる', 'た', '絵画']
パパッパラパッパララッパッパ | ['パパッパラパッパララッパッパ']
謎々かぞえて遊びましょう | ['謎', '々', 'かぞえる', 'て', '遊ぶ', 'ます', 'う']
タタッタラタッタララッタッタ | ['タタッタラタッタララッタッタ']
何故何故此処で | ['何故', '何故', '此処', 'で']
踊っているでしょう | ['踊る', 'て', 'いる', 'です', 'う']
簡単なことも解らないわ | ['簡単', 'だ', 'こと', 'も', '解る', 'ない', 'わ']

None type
106: Harumachi Clover | Will Stetson
A-one, a-two, a-one, two | ['A', '-', 'one', ',', 'a', '-', 'two', ',', 'a', '-', 'one', ',', 'two']
目の前の扉をあけたら春風 | ['目', 'の', '前', 'の', '扉', 'を', 'あける', 'た', '春風']
鳥たちも木々で待ち合わせ | ['鳥', 'たち', 'も', '木々', 'で', '待ち合わせ']

107: FREEDOM | Ado
嫌われないように | ['嫌う', 'れる', 'ない', 'よう', 'に']
ビクビク下ばかり見ていたって | ['ビクビク', '下', 'ばかり', '見る', 'て', 'いる', 'た', 'って']
何も変わんないさ | ['何', 'も', '変わる', 'ない', 'さ']
迷わずに突き進め step & step | ['迷う', 'ぬ', 'に', '突き進める', 'step', '&', 'step']
奪われないように | ['奪う', 'れる', 'ない', 'よう', 'に']
コソコソして隠したがったって | ['コソコソ', 'する', 'て', '隠す', 'たい', 'がる', 'た', 'って']
「私らしさ」って | ['「', '私', 'らしい', 'さ', '」', 'って']
武器へと変えて切り開いていけ | ['武器', 'へ', 'と', '変える', 'て', '切り開く', 'て', 'いく']
文句があるなら | ['文句', 'が', 'ある', 'だ']
正面堂々とぶつかって | ['正面', '堂々', 'と', 'ぶつかる', 'て']
言い訳無用で | ['言い訳', '無用', 'だ']
さぁ one, two, one, two, three, four | ['さぁ', 'one', ',', 'two', ',', 'one', ',', 'two', ',', 'three', ',', 'four']
上等さ 取るに足んない | ['上等', 'さ', '取る', 'に', '足る', 'ない']
同情じゃ救えないから | ['同情', 'じゃ', '救える', 'ない', 'から']
You and I ガチの勝敗 | ['You', 'and', 'I', 'ガチ', 'の', '勝敗']
革命を起こせ | ['革命', 'を', '起こせる']
同調は二束三文 | ['同調', 'は', '二束三文']

108: Yoino Myojo | Eve
燻る煙眺めては咽る | ['燻る', '煙', '眺める', 'て', 'は', '咽', 'る']
履き潰したこの靴はまだ僕を | ['履く', '潰す', 'た', 'この', '靴', 'は', 'まだ', '僕', 'を']
連れ出してくれよ 最高の思い出も | ['連れ出す', 'て', 'くれる', 'よ', '最高', 'の', '思い出', 'も']
快活なイエロー あっという間のメロウ | ['快活', 'だ', 'イエロー', 'あっという間', 'の', 'メロウ']
残響 気分 焔になって | ['残響', '気分', '焔', 'に', 'なる', 'て']
愛そう 自分 素直になって | ['愛す', 'う', '自分', '素直', 'に', 'なる', 'て']
まだ見ぬ 閃光になって | ['まだ', '見る', 'ぬ', '閃光', 'に', 'なる', 'て']
想いが 溢れてしまう | ['想い', 'が', '溢れる', 'て', 'しまう']
愛しい顔した 月は陰り優しく | ['愛しい', '顔', 'する', 'た', '月', 'は', '陰り', '優しい']
時に寂しさ紛らわせ眠る | ['時に', '寂しい', 'さ', '紛らわせる', '眠る']
今だけは1人でいたいだけ | ['今', 'だけ', 'は', '1', '人', 'で', 'いたい', 'だけ']
いたいだけ | ['いたい', 'だけ']
風光る兆し手を伸ばせば広がるよう 足は止めぬよう | ['風', '光る', '兆し', '手', 'を', '伸ばす', 'ば', '広がる', 'よう', '足', 'は', '止める', 'ぬ', 'よう']
まだ聞こえるかい 今ただその音に乗って | ['まだ', '聞こえる', 'かい', '今', 'ただ', 'その', '音', 'に', '乗る', 'て']

109: Fleeting Lullaby | Ado
ひとりぼっちには飽き飽きなの | ['ひとり', 'ぼる', 'ちる', 'に', 'は', '飽きる', '飽き', 'だ', 'の']
繋がっていたいの | ['繋がる', 'て', 'いる', 'たい', 'の']
純真無垢な想いのまま loud out (loud out) | ['純真', '無垢', 'だ', '想い', 'の', 'まま', 'loud', 'out', '(', 'loud', 'out', ')']
Listen up, baby 消えない染みのようなハピネス | ['Listen', 'up', ',', 'baby', '消える', 'ない', '染み', 'の', 'よう', 'だ', 'ハピネス']
君の耳の奥へホーミング 逃げちゃダメよ浴びて | ['君', 'の', '耳', 'の', '奥', 'へ', 'ホーミング', '逃げる', 'ちゃ', 'ダメ', 'よ', '浴びる', 'て']
他の追随許さないウタの綴るサプライズ | ['他', 'の', '追随', '許す', 'ない', 'ウタ', 'の', '綴る', 'サプライズ']
リアルなんて要らないよね？ | ['リアル', 'なんて', '要る', 'ない', 'よ', 'ね', '?']
後で気付いたってもう遅い | ['後で', '気付く', 'た', 'って', 'もう', '遅い']
入れてあげないんだから | ['入れる', 'て', 'あげる', 'ない', 'ん', 'だ', 'から']
手間取らせないで be my good, good, good boys and girls | ['手間取る', 'せる', 'ない', 'で', 'b', 'e', 'm', 'y', 'good', ',', 'good', ',', 'good', 'boys', 'and', 'girls']
誤魔化して強がらないでもう | ['誤魔化す', 'て', '強がる', 'ない', 'でも', 'う']
ほら早くこっちおいで | ['ほら', '早い', 'こっち', 'おいで']
全てが楽しいこのステージ上 一緒に歌おうよ | ['全て', 'が', '楽しい', 'この', 'ステージ', '上', '一緒', 'に', '歌う', 'う', 'よ']
Haha! I wanna make your day, do my thing 堂々と | ['Haha', '!', 'I', 'wanna', 'make', 'your', 'day', ',', 'd', 'o', 'm', 'y', 'thing', '堂々', 'と']
Hey ねぇ 教えて何がいけないの？ | ['H', 'e', 'y', 'ねぇ', '教える', 'て', '何', 'が', 'いける', 'ない', 'の', '?']
この場はユートピア だって望み通りでしょ？ | ['この', '場', 'は', 'ユートピア', 'だって', '望み', '通り', 'です', '?']
突発的な泡沫なんて言わせない | ['突発', '的', 'だ', '泡沫', 'なんて', '言う', 'せる', 'ない']

110: Ambivalent | Eve
その足を踏み出せないでいるのかい | ['その', '足', 'を', '踏み出せる', 'ない', 'で', 'いる', 'の', 'かい']
自分が傷つくことが嫌な癖に | ['自分', 'が', '傷つく', 'こと', 'が', '嫌', 'だ', '癖', 'に']
いつの日か熱量や感情さえも | ['いつ', 'の', '日', 'か', '熱量', 'や', '感情', 'さえ', 'も']
どっかに置き去りになって | ['どっか', 'に', '置き去り', 'に', 'なる', 'て']
抜け殻になってしまう でも目を背けるの | ['抜け殻', 'に', 'なる', 'て', 'しまう', 'でも', '目', 'を', '背ける', 'の']
その心の扉を今ノックして尋ねてみたんだ | ['その', '心', 'の', '扉', 'を', '今', 'ノック', 'する', 'て', '尋ねる', 'て', 'みる', 'た', 'ん', 'だ']
本当の気持ちを知りたくて聞かせて | ['本当', 'の', '気持ち', 'を', '知る', 'たい', 'て', '聞く', 'せる', 'て']
君は感情的で 時には冷静沈着で | ['君', 'は', '感情', '的', 'だ', '時には', '冷静', '沈着', 'だ']
相棒は自慢な証明 いきたいないきたいな | ['相棒', 'は', '自慢', 'だ', '証明', 'いきる', 'たい', 'な', 'いきる', 'たい', 'な']
もう一度だけ 呼吸を合わせて 合図を送るから | ['もう一度', 'だけ', '呼吸', 'を', '合わせる', 'て', '合図', 'を', '送る', 'から']
この僕の心を沸かせて沸せてくれ | ['この', '僕', 'の', '心', 'を', '沸く', 'せる', 'て', '沸', 'せる', 'て', 'くれる']

111: 祝福 | YOASOBI
遥か遠くに浮かぶ星を | ['遥か', '遠く', 'に', '浮かぶ', '星', 'を']
想い眠りにつく君の | ['想い', '眠り', 'に', 'つく', '君', 'の']
選ぶ未来が望む道が | ['選ぶ', '未来', 'が', '望む', '道', 'が']
何処へ続いていても | ['何処', 'へ', '続く', 'て', 'いる', 'て', 'も']
共に生きるから | ['共に', '生きる', 'から']
ずっと昔の記憶 | ['ずっと', '昔', 'の', '記憶']
連れられて来たこの星で君は | ['連れる', 'られる', 'て', '来る', 'た', 'この', '星', 'で', '君', 'は']
願い続けてた | ['願う', '続ける', 'てる', 'た']
遠くで煌めく景色に | ['遠く', 'で', '煌めく', '景色', 'に']
飛び込むことが出来たのなら | ['飛び込む', 'こと', 'が', '出来る', 'た', 'の', 'だ']
一人孤独な世界で | ['一', '人', '孤独', 'だ', '世界', 'で']
祈り願う | ['祈る', '願う']
夢を描き | ['夢', 'を', '描く']
未来を見る | ['未来', 'を', '見る']
逃げ出すよりも進むことを | ['逃げ出す', 'より', 'も', '進む', 'こと', 'を']
君が選んだのなら | ['君', 'が', '選ぶ', 'だ', 'の', 'だ']
誰かが描いたイメージじゃなくて | ['誰', 'か', 'が', '描く', 'た', 'イメージ', 'じゃ', 'ない', 'て']

112: アンコール | YOASOBI
明日世界は終わるんだって | ['明日', '世界', 'は', '終わる', 'ん', 'だって']
君にはもう会えないんだって | ['君', 'に', 'は', 'もう', '会える', 'ない', 'ん', 'だって']
またいつかって手を振ったって | ['また', 'いつか', 'って', '手', 'を', '振る', 'た', 'って']
叶わないんだよ | ['叶う', 'ない', 'ん', 'だ', 'よ']
仕方ないね | ['仕方', 'ない', 'ね']
明日世界は終わるんだって | ['明日', '世界', 'は', '終わる', 'ん', 'だって']
それならもう | ['それなら', 'もう']
その時まで何度でもずっと | ['その', '時', 'まで', '何', '度', 'でも', 'ずっと']
好きな音を鳴らそう | ['好き', 'だ', '音', 'を', '鳴らす', 'う']
薄暗闇に包まれた | ['薄', '暗闇', 'に', '包む', 'れる', 'た']
見覚えのない場所、目を覚ます | ['見覚え', 'の', 'ない', '場所', '、', '目', 'を', '覚ます']
ここは夜のない世界 | ['ここ', 'は', '夜', 'の', 'ない', '世界']
今日で終わる世界 | ['今日', 'で', '終わる', '世界']
そんな日にあなたに出会った | ['そんな', '日', 'に', 'あなた', 'に', '出会う', 'た']
好きにしていいと | ['好き', 'に', 'する', 'て', 'いい', 'と']
それだけ残して | ['それだけ', '残す', 'て']
何処かへゆく | ['何処', 'か', 'へ', 'ゆく']
あなたの音が遠ざかってく | ['あなた', 'の', '音', 'が', '遠ざかる', 'て', 'く']
そしてまたひとり | ['そして', 'また', 'ひとり']
淀んだ空気の中で | ['淀む', 'だ', '空気', 'の', '中', 'で']

113: トウキョウ・シャンディ・ランデヴ | MAISONdes
電波テンポアップして絶賛感電中！ | ['電波', 'テンポ', 'アップ', 'する', 'て', '絶賛', '感電', '中', '!']
あなたにもわすれたいこと かなしいこと | ['あなた', 'に', 'も', 'わすれる', 'たい', 'こと', 'かなしい', 'こと']
あるのかしらね | ['ある', 'の', 'かしら', 'ね']
識らない映画なのに涙をながすのは | ['識', 'ら', 'ない', '映画', 'だ', 'のに', '涙', 'を', 'ながす', 'の', 'は']
ドラマチックが足りてないからよ | ['ドラマチック', 'が', '足る', 'てる', 'ない', 'から', 'よ']
そんな愚にも付かないこと くだらないこと | ['そんな', '愚', 'に', 'も', '付く', 'ない', 'こと', 'くだらない', 'こと']
考えてばかりね | ['考える', 'て', 'ばかり', 'ね']
雨が上がれば愛もその横顔も | ['雨', 'が', '上がる', 'ば', '愛', 'も', 'その', '横顔', 'も']
誰かのものになるのでしょう | ['誰', 'か', 'の', 'もの', 'に', 'なる', 'の', 'です', 'う']
嘘っぱちのファンデーションも全部今夜のためよ | ['嘘っぱち', 'の', 'ファンデーション', 'も', '全部', '今夜', 'の', 'ため', 'よ']
なのに一体全体 如何して如何して 何故何故 ？ | ['なのに', '一体全体', '如何', 'する', 'て', '如何', 'する', 'て', '何故', '何故', '?']
不安定なカンテラ 何処まで行くの | ['不安定', 'だ', 'カンテラ', '何処', 'まで', '行く', 'の']
あなた一切合切放り去ってもう | ['あなた', '一切合切', '放る', '去る', 'て', 'もう']
冗談じゃあないないわ | ['冗談', 'じゃあ', 'ない', 'ない', 'わ']
トウキョウ・シャンディ・ランデヴ | ['トウキョウ・シャンディ・ランデヴ']
その時が来たって如何にもならないぜ | ['その', '時', 'が', '来る', 'た', 'って', '如何', 'に', 'も', 'なる', 'ない', 'ぜ']

114: FightSong | Eve
盤上に立っていた チクリ棘を刺すようなこの痛みなど | ['盤上', 'に', '立つ', 'て', 'いる', 'た', 'チクリ', '棘', 'を', '刺す', 'よう', 'だ', 'この', '痛み', 'など']
焦燥の正体に 夢と勘違いしたくなる心模様 | ['焦燥', 'の', '正体', 'に', '夢', 'と', '勘違い', 'する', 'たい', 'なる', '心', '模様']
いつだって ただから回るヘイデイ | ['いつ', 'だって', 'ただ', 'から', '回る', 'ヘイデイ']
伝って なんて交わせばメイデイ | ['伝う', 'て', 'なんて', '交わす', 'ば', 'メイデイ']
大人になったって 今みたいな頭でらったったった | ['大人', 'に', 'なる', 'たって', '今', 'みたい', 'だ', '頭', 'で', 'ら', 'く', 'たつ', 'たった']
ただ君のナンセンスが 嘘みたいな視界を奪う言葉なら | ['ただ', '君', 'の', 'ナンセンス', 'が', '嘘', 'みたい', 'だ', '視界', 'を', '奪う', '言葉', 'だ']
復讐の正体が 肺にのめり込んだみたい 鉛さえも | ['復讐', 'の', '正体', 'が', '肺', 'に', 'のめり込む', 'だ', 'みたい', '鉛', 'さえ', 'も']
寄りかかりあって生きてる人生 | ['寄りかかる', 'ある', 'て', '生きる', 'てる', '人生']
依存したい衝動に酩酊 | ['依存', 'する', 'たい', '衝動', 'に', '酩酊']
化けを纏ったって 役に立つ居場所があるなら | ['化け', 'を', '纏う', 'たって', '役に立つ', '居場所', 'が', 'ある', 'だ']
夜はまだ明けぬまま 夢をみよう | ['夜', 'は', 'まだ', '明ける', 'ぬ', 'まま', '夢', 'を', 'みる', 'う']
僕にだって ねえ 未来に駆けていけ | ['僕', 'に', 'だって', 'ねえ', '未来', 'に', '駆ける', 'て', 'いく']
祈るような死線へ | ['祈る', 'よう', 'だ', '死線', 'へ']
怒りに身を任せ 時に冷静でいて | ['怒り', 'に', '身', 'を', '任せる', '時に', '冷静', 'だ', 'いる', 'て']
契りを交わした少年 | ['契り', 'を', '交わす', 'た', '少年']
あの頃みたいな今日が | ['あの', '頃', 'みたい', 'だ', '今日', 'が']

115: Neppa | tephe
網戸からこぼれる | ['網戸', 'から', 'こぼれる']
燃え立つ陽に | ['燃え立つ', '陽', 'に']
背中を向けてさ | ['背中', 'を', '向ける', 'て', 'さ']
「今日は何をしようかな」 | ['「', '今日', 'は', '何', 'を', 'する', 'う', 'か', 'な', '」']
その呟きが枕で消された | ['その', '呟く', 'が', '枕', 'で', '消す', 'れる', 'た']
目に映ずる陽炎 | ['目', 'に', '映ずる', '陽炎']
セミ達は鳴り | ['セミ', '達', 'は', '鳴り']

116: Bokurano | Eve
白も黒もない世界 | ['白', 'も', '黒', 'も', 'ない', '世界']
憎しみの奥で泣いていた | ['憎しみ', 'の', '奥', 'で', '泣く', 'て', 'いる', 'た']
立ち止まることも許されない | ['立ち止まる', 'こと', 'も', '許す', 'れる', 'ない']
ただその向こうへ | ['ただ', 'その', '向こう', 'へ']
独り 焦燥 暴走 | ['独り', '焦燥', '暴走']
背負ってきた末路は | ['背負う', 'て', 'くる', 'た', '末路', 'は']
歩みも困難な君をまだ | ['歩み', 'も', '困難', 'だ', '君', 'を', 'まだ']
救う手立てはあるのかい | ['救う', '手立て', 'は', 'ある', 'の', 'かい']
諦めてしまいそうになったら | ['諦める', 'て', 'しまう', 'そう', 'に', 'なる', 'た']
どこへでも駆けつける | ['どこ', 'へ', 'で', 'も', '駆けつける']
僕らの想いも全部 離さないよ全部 | ['僕ら', 'の', '想い', 'も', '全部', '離す', 'ない', 'よ', '全部']
余計なお世話 だって隣に居たいのさ | ['余計', 'だ', 'お世話', 'だって', '隣', 'に', '居る', 'たい', 'の', 'さ']
それがヒーロー | ['それ', 'が', 'ヒーロー']
紡いだ声も全部 失くさないよ全部 | ['紡ぐ', 'だ', '声', 'も', '全部', '失', 'くさい', 'ない', 'よ', '全部']
何度だって立ち上がってみせるから | ['何', '度', 'だって', '立ち上がる', 'て', 'みせる', 'から']
命燃やしていけ | ['命', '燃やす', 'て', 'いく']

117: KING | Kanaria
幽閉 利口 逝く前に ユーヘイじゃ利口に難儀ダーリン | ['幽閉', '利口', '逝く', '前', 'に', 'ユーヘイ', 'じゃ', '利口', 'に', '難儀', 'ダーリン']
幽閉 ストップ 知ってないし | ['幽閉', 'ストップ', '知る', 'てる', 'ない', 'し']
勘弁にしといてなんて惨忍 | ['勘弁', 'に', 'する', 'とく', 'て', 'なんて', '惨い', '忍']
人様願う欠片のアイロニ | ['人様', '願う', '欠片', 'の', 'アイロニ']
だれもが願う無機質なような | ['だれ', 'も', 'が', '願う', '無機質', 'だ', 'よう', 'だ']
一足先に始めてたいような 先が見えない | ['一足', '先', 'に', '始める', 'てる', 'たい', 'よう', 'だ', '先', 'が', '見える', 'ない']
ヴァージンハッピーショー | ['ヴァージンハッピーショー']
無いの新たにお願い1つ | ['無い', 'の', '新た', 'に', 'お願い', '1つ']
愛も変わらずおまけにワーニング ワーニング | ['愛', 'も', '変わる', 'ぬ', 'おまけ', 'に', 'ワーニング', 'ワーニング']
無いのあなたにお願い1つ | ['無い', 'の', 'あなた', 'に', 'お願い', '1つ']
張り詰めた思い込め | ['張り詰める', 'た', '思い込む']
レフトサイド ライトサイド | ['レフト', 'サイド', 'ライト', 'サイド']
歯をむき出して | ['歯', 'を', 'むき出す', 'て']

118: veil | 須田景凪
笑えない日々を辿ったって | ['笑える', 'ない', '日々', 'を', '辿る', 'た', 'って']
変わらない今を呪ったって | ['変わる', 'ない', '今', 'を', '呪う', 'たって']
宙に舞った言葉じゃ | ['宙', 'に', '舞う', 'た', '言葉', 'じゃ']
あなたを救えないのだろう | ['あなた', 'を', '救える', 'ない', 'の', 'だ', 'う']
届かないままの景色と | ['届く', 'ない', 'まま', 'の', '景色', 'と']
温まることない痛みと | ['温まる', 'こと', 'ない', '痛み', 'と']
肩を寄せ合って歩いていた | ['肩', 'を', '寄せる', '合う', 'て', '歩く', 'て', 'いる', 'た']
遠いところへ行けるように | ['遠い', 'ところ', 'へ', '行ける', 'よう', 'に']
あなたの言う希望だとか | ['あなた', 'の', '言う', '希望', 'だ', 'と', 'か']
夢に見た理想ならば | ['夢', 'に', '見る', 'た', '理想', 'だ', 'ば']
どんなに冷たくたって愛してみせるよ | ['どんなに', '冷たい', 'たつ', 'て', '愛す', 'て', 'みせる', 'よ']
笑えない日々を辿ったって | ['笑える', 'ない', '日々', 'を', '辿る', 'た', 'って']
変わらない今を呪ったって | ['変わる', 'ない', '今', 'を', '呪う', 'たって']
宙に舞った言葉じゃ | ['宙', 'に', '舞う', 'た', '言葉', 'じゃ']
あなたを救えないのだろう | ['あなた', 'を', '救える', 'ない', 'の', 'だ', 'う']
不甲斐ない声で叫んだって | ['不甲斐ない', '声', 'で', '叫ぶ', 'だ', 'って']

None type
120: EASY LOVE | Sumire Uesaka
イジけてないで (easy!) | ['イジ', 'け', 'てる', 'ない', 'で', '(', 'easy', '!', ')']
Easy, easy, everyday (easy!) | ['Easy', ',', 'easy', ',', 'everyday', '(', 'easy', '!', ')']
だんだん近づくもんじゃない | ['だんだん', '近づく', 'もん', 'じゃ', 'ない']
どういう反応書いてない | ['どういう', '反応', '書く', 'てる', 'ない']
気になっちゃってさしょうがない | ['気', 'に', 'なる', 'ちゃう', 'て', 'さ', 'しょうが', 'ない']
エネルギー | ['エネルギー']
女の子は あーだこーだ | ['女の子', 'は', 'あー', 'だこ', 'ー', 'だ']
妄想願望 ただの空想 | ['妄想', '願望', 'ただ', 'の', '空想']
ほら しぼり出せ | ['ほら', 'しぼる', '出す']
何度だって負かしたい | ['何', '度', 'だって', '負かす', 'たい']
だって君はかわいい | ['だって', '君', 'は', 'かわいい']
反撃はしないでよ | ['反撃', 'は', 'する', 'ない', 'で', 'よ']
押し切って完全勝利 | ['押し切る', 'て', '完全', '勝利']
好きだから 好きなだけ | ['好き', 'だ', 'から', '好き', 'だ', 'だけ']
台無しにしたいの | ['台無し', 'に', 'する', 'たい', 'の']
Easy love (easy love!) | ['Easy', 'love', '(', 'easy', 'love', '!', ')']
Easy love（ないで！） | ['Easy', 'love', '(', 'ない', 'で', '!', ')']
ね 君にだけ | ['ね', '君', 'に', 'だけ']
まだ知らない 青い春 | ['まだ', '知る', 'ない', '青い', '春']
目覚める気持ちは | ['目覚める', '気持ち', 'は']
Easy love (easy love!) | ['Easy', 'love', '(', 'easy', 'love', '!', ')']
Easy love（ないで！） | ['Easy', 'love', '(', 'ない', 'で', '!', ')']
Easy love (easy love!) | ['Easy', 'love', '(', 'easy', 'love', '!', ')']
愛のカタチ | ['愛', 'の', 'カタチ']
イジけてないで (easy!) | ['イジ', 'け', 'てる', 'ない', 'で', '(', 'easy', '!', ')']
意地はらないで (easy!) | ['意地', 'はる', 'ない', 'で', '(', 'easy', '!', ')']
Easy, easy, everyday (easy!) | ['Easy', ',', 'easy', ',', 'everyday', '(', 'easy', '!', ')']
騒ぎまくりましょう | ['騒ぐ', 'まくる', 'ます', 'う']

121: Tokyo Ghetto | Eve
誰でもいいや 誰でもいいから 誰かいないか | ['誰', 'でも', 'いい', 'や', '誰', 'でも', 'いい', 'から', '誰', 'か', 'いる', 'ない', 'か']
声ではないが 睨む視線が ２つと在ると思えた | ['声', 'で', 'は', 'ない', 'が', '睨む', '視線', 'が', '2つ', 'と', '在る', 'と', '思える', 'た']
これでおさらば 呪縛からさらば 夜が解けた | ['これ', 'で', 'おさらば', '呪縛', 'から', 'さらば', '夜', 'が', '解ける', 'た']
好奇心だった 有刺鉄線の 向こう側へと | ['好奇', '心', 'だ', 'た', '有刺鉄線', 'の', '向こう', '側', 'へ', 'と']
全然興味ないって 蝶が舞い込めば | ['全然', '興味', 'ない', 'って', '蝶', 'が', '舞い込む', 'ば']
想像通りだった といえば嘘になるが | ['想像', '通り', 'だ', 'た', 'と', 'いう', 'ば', '嘘', 'に', 'なる', 'が']
退廃的だった コーヒーの泡を溢した | ['退廃', '的', 'だ', 'た', 'コーヒー', 'の', '泡', 'を', '溢', 'する', 'た']
そんなそんな 毎日だった 僕の前に | ['そんな', 'そんな', '毎日', 'だ', 'た', '僕', 'の', '前', 'に']
現れた君は | ['現れる', 'た', '君', 'は']
どうしたってどうしたって 進めないままだ | ['どう', 'する', 'た', 'って', 'どう', 'する', 'た', 'って', '進める', 'ない', 'まま', 'だ']
ヒッピーなこの街の性に | ['ヒッピー', 'だ', 'この', '街', 'の', '性', 'に']
どうやってどうやって 理由を | ['どう', 'やる', 'て', 'どう', 'やる', 'て', '理由', 'を']

None type
123: Kokoroyohou | Eve
浮つく甘い街の喧騒 | ['浮つく', '甘い', '街', 'の', '喧騒']
故に感情線は渋滞 | ['故に', '感情', '線', 'は', '渋滞']
「僕に関係ない」とか言って | ['「', '僕', 'に', '関係', 'ない', '」', 'とか', '言う', 'て']
心模様 白く染まって | ['心', '模様', '白い', '染まる', 'て']
だけどどうやったって釣り合わない | ['だけど', 'どう', 'やる', 'た', 'って', '釣り合う', 'ない']
いたずらに笑う横顔に乾杯 | ['いたずら', 'に', '笑う', '横顔', 'に', '乾杯']
酸いも甘いもわからないの | ['酸い', 'も', '甘い', 'も', 'わかる', 'ない', 'の']
きっと君の前では迷子 | ['きっと', '君', 'の', '前', 'で', 'は', '迷子']
溶かしてはランデブー | ['溶かす', 'て', 'は', 'ランデブー']
プラトニックになってく | ['プラトニック', 'に', 'なる', 'て', 'く']
ほろ苦い期待 張り裂けてしまいそう | ['ほろ苦い', '期待', '張り裂ける', 'て', 'しまう', 'そう']
だから | ['だから']
夢惑う 想いならば | ['夢', '惑う', '想い', 'だ', 'ば']
聞かせて その声を | ['聞く', 'せる', 'て', 'その', '声', 'を']
君に染まってしまえば 染まってしまえば | ['君', 'に', '染まる', 'て', 'しまう', 'ば', '染まる', 'て', 'しまう', 'ば']
心遊ばせ 余所見してないで | ['心', '遊ばせる', '余所見', 'する', 'てる', 'ない', 'で']

124: Sing My Pleasure | ヴィヴィ(Vo.八木海莉)
(As you like, my pleasure) | ['(', 'A', 's', 'you', 'like', ',', 'm', 'y', 'pleasure', ')']
光を目指して生まれてきた | ['光', 'を', '目指す', 'て', '生まれる', 'て', 'くる', 'た']
絆 細い糸に結ばれて | ['絆', '細い', '糸', 'に', '結ぶ', 'れる', 'て']
使命で目覚めた幸福から | ['使命', 'で', '目覚める', 'た', '幸福', 'から']
紡ぐ いくつもの誇らしい 記憶 | ['紡ぐ', 'いくつ', 'も', 'の', '誇らしい', '記憶']
あなたのために | ['あなた', 'の', 'ため', 'に']
この世界へ感謝と | ['この', '世界', 'へ', '感謝', 'と']
宇宙いっぱいの 花束を | ['宇宙', 'いっぱい', 'の', '花束', 'を']
宿命さえ 運命さえも どうぞ輝かせて | ['宿命', 'さえ', '運命', 'さえ', 'も', 'どうぞ', '輝く', 'せる', 'て']
楽しんだり 笑う者を 守れる喜び | ['楽しい', 'ん', 'だり', '笑う', '者', 'を', '守れる', '喜び']
憧れてる 憧れている もっと強くなれる | ['憧れる', 'てる', '憧れる', 'て', 'いる', 'もっと', '強い', 'なれる']
泣き声さえ 歌のように 聴かせてあげたい | ['泣き声', 'さえ', '歌', 'の', 'よう', 'に', '聴く', 'せる', 'て', 'あげる', 'たい']
このめくるめく時間に | ['この', 'めくるめく', '時間', 'に']

125: パステルレイン | Sangatsu no Phantasia
さっきのは冗談よ | ['さっき', 'の', 'は', '冗談', 'よ']
余計に遠ざかる もどかしい言葉は | ['余計', 'に', '遠ざかる', 'もどかしい', '言葉', 'は']
低気圧のせいだ | ['低', '気圧', 'の', 'せい', 'だ']
覗き込んでみたって 鏡は鏡 | ['覗き', '込む', 'で', 'みる', 'た', 'って', '鏡', 'は', '鏡']
水たまり 独り言だよ | ['水たまり', '独り言', 'だ', 'よ']
こだまして 反射して | ['こだま', 'する', 'て', '反射', 'する', 'て']
ふとした瞬間にときめいて | ['ふとした', '瞬間', 'に', 'ときめく', 'て']
平然なんてきっと思う程 | ['平然', 'なんて', 'きっと', '思う', '程']
上手く出来そうにない かなしいほどに | ['上手い', '出来る', 'そう', 'に', 'ない', 'かなしい', 'ほど', 'に']
止まない雨は無い なんて君は言う | ['止む', 'ない', '雨', 'は', '無い', 'なんて', '君', 'は', '言う']
ならもうちょっと私 濡れていくわ | ['なら', 'もう', 'ちょっと', '私', '濡れる', 'て', 'いく', 'わ']
何もかも洗い流してはくれないけど | ['何もかも', '洗い流す', 'て', 'は', 'くれる', 'ない', 'けど']
パステルレイン 滲ませてしまったのは | ['パステルレイン', '滲む', 'せる', 'て', 'しまう', 'た', 'の', 'は']

126: oyasumi | Shiggy Jr.
雨が少し降ってる ただそれだけの理由で | ['雨', 'が', '少し', '降る', 'てる', 'ただ', 'それだけ', 'の', '理由', 'で']
外には出たくないから 自宅待機してる | ['外', 'に', 'は', '出る', 'たい', 'ない', 'から', '自宅', '待機', 'する', 'てる']
神様 面倒くさがりダメダメ僕を許してくれないかい | ['神様', '面倒い', 'する', 'がる', 'ダメダメ', '僕', 'を', '許す', 'て', 'くれる', 'ない', 'かい']
1、2、3で拝むから こんな感じでいいよね | ['1', '、', '2', '、', '3', 'で', '拝む', 'から', 'こんな', '感じ', 'だ', 'いい', 'よ', 'ね']
ねぇ もう こんなんじゃ嫌よ 散々な日々ってなんで？ | ['ねぇ', 'もう', 'こんな', 'ん', 'じゃ', '嫌', 'よ', '散々', 'だ', '日々', 'ってな', 'んで', '?']
寝よう 早く寝よう 忘れられたら最高なんで | ['寝る', 'う', '早い', '寝る', 'う', '忘れる', 'られる', 'た', '最高', 'だ', 'んで']
電話が鳴り続けてる 昼間一人の部屋で | ['電話', 'が', '鳴る', '続ける', 'てる', '昼間', '一', '人', 'の', '部屋', 'で']
出たくなんかないから 言い訳探してる | ['出る', 'たい', 'なんか', 'ない', 'から', '言い訳', '探す', 'てる']

127: Taikutsuwo Saienshinaide | Eve
穿っては咲いた ブルー | ['穿つ', 'て', 'は', '咲く', 'た', 'ブルー']
ただこの間に割ってはランデブー | ['ただ', 'この間', 'に', '割る', 'て', 'は', 'ランデブー']
花言葉に柄にない飾り気ないと | ['花言葉', 'に', '柄', 'に', 'ない', '飾り気', 'ない', 'と']
絡み合った瞬間 だらだらしたくて | ['絡み合う', 'た', '瞬間', 'だらだら', 'する', 'たい', 'て']
甘い 消耗 無いような | ['甘い', '消耗', '無い', 'よう', 'だ']
ふと毎晩想いを吐くような | ['ふと', '毎晩', '想い', 'を', '吐く', 'よう', 'だ']
きっと何回本気なモーション | ['きっと', '何', '回', '本気', 'だ', 'モー', 'ション']
なんたって今日は記念日バースデイ | ['なん', 'たつ', 'て', '今日', 'は', '記念', '日', 'バースデイ']
裸になったって | ['裸', 'に', 'なる', 'た', 'って']
何も見えちゃしない | ['何', 'も', '見える', 'ちゃ', 'する', 'ない']
言葉にしたって薄っぺらいの | ['言葉', 'に', 'する', 'た', 'って', '薄っぺら', 'いぬ']
悶々とした | ['悶々', 'と', 'する', 'た']
夢の中のハイウェイは | ['夢', 'の', '中', 'の', 'ハイウェイ', 'は']
温かく冷たい 灰色の正体暴きたい | ['温かい', '冷たい', '灰色', 'の', '正体', '暴く', 'たい']
夢にまで見たような世界から明けて | ['夢', 'に', 'まで', '見る', 'た', 'よう', 'だ', '世界', 'から', '明ける', 'て']
大丈夫、甲斐性はないが | ['大丈夫', '、', '甲斐性', 'は', 'ない', 'が']
冗談じゃないさ 突き進もう | ['冗談', 'じゃ', 'ない', 'さ', '突き進む', 'う']
最終章の声も 溶かしてしまう生涯ね | ['最', '終章', 'の', '声', 'も', '溶かす', 'て', 'しまう', '生涯', 'ね']
ありふれた夜を聞かせてと | ['ありふれる', 'た', '夜', 'を', '聞く', 'せる', 'て', 'と']
思い出すように吐く後悔を | ['思い出す', 'よう', 'に', '吐く', '後悔', 'を']

None type
129: Nonsense Bungaku | Eve
感情的にはなれない 今更臆病になって | ['感情', '的', 'に', 'はなれる', 'ない', '今更', '臆病', 'に', 'なる', 'て']
研ぎ澄んだ言の刃 大事そう 抱え笑って | ['研ぐ', '澄む', 'だ', '言', 'の', '刃', '大事', 'そう', '抱え', '笑う', 'て']
ドクドクドク ハイテンション | ['ドクドクドク', 'ハイ', 'テンション']
吸って吸って 吐き出せない | ['吸う', 'て', '吸う', 'て', '吐き出せる', 'ない']
へそまがりなアンタに嫌気がさしていく | ['へ', 'そむ', 'がる', 'だ', 'アンタ', 'に', '嫌気', 'が', 'さす', 'て', 'いく']
真昼のランデブー | ['真昼', 'の', 'ランデブー']
ビビディバビデブー | ['ビビディバビデブー']
孤独の愛を 注いであげましょう | ['孤独', 'の', '愛', 'を', '注ぐ', 'で', 'あげる', 'ます', 'う']
心が病んでく 僕らは今日 | ['心', 'が', '病む', 'で', 'く', '僕ら', 'は', '今日']
生まれ変わりましょう | ['生まれ変わる', 'ます', 'う']
僕ら 馬鹿になって 宙を舞って | ['僕ら', '馬鹿', 'に', 'なる', 'て', '宙', 'を', '舞う', 'て']
今だけは忘れてﾗｯﾀｯﾀ(ﾗｯﾀｯﾀ) | ['今', 'だけ', 'は', '忘れる', 'て', 'ラッタッタ', '(', 'ラッタッタ', ')']
踊りあかそう この夜を沸かそう | ['踊りあかす', 'う', 'この', '夜', 'を', '沸かす', 'う']
涙はほいっ して 眠らないように | ['涙', 'は', 'ほる', 'いく', 'する', 'て', '眠る', 'ない', 'よう', 'に']
嘘になって しまわぬように | ['嘘', 'に', 'なる', 'て', 'しまう', 'ぬ', 'よう', 'に']
僕じゃない僕にもﾗｯﾀｯﾀ(ﾗｯﾀｯﾀ) | ['僕', 'じゃ', 'ない', '僕', 'に', 'も', 'ラッタッタ', '(', 'ラッタッタ', ')']
最低で憂鬱な日々でさえ | ['最低', 'で', '憂鬱', 'だ', '日々', 'で', 'さえ']
君となら僕は明かしてみたい | ['君', 'と', 'だ', '僕', 'は', '明かす', 'て', 'みる', 'たい']

130: サラマンダー | DECO*27

None type
None type
133: ヒステリックナイトガール | PSYQUI
最低なんて言わないで | ['最低', 'なんて', '言う', 'ない', 'で']
「大変、遺憾」で大正解 | ['「', '大変', '、', '遺憾', '」', 'で', '大', '正解']
再現だって難無くクリアです | ['再現', 'だって', '難無く', 'クリア', 'です']
「しょうがないよ」いつもの言葉 ケリ着いた体で | ['「', 'しょうが', 'ない', 'よ', '」', 'いつも', 'の', '言葉', 'ケリ', '着く', 'た', '体', 'で']
目もくれず ベッドの上 臥す | ['目', 'も', 'くれる', 'ぬ', 'ベッド', 'の', '上', '臥す']
段々こっちもイラついて 罵声 怒号 | ['段々', 'こっち', 'も', 'イラ', 'つく', 'て', '罵声', '怒号']
浴びせ合うは 言うに事欠く dis | ['浴びせる', '合う', 'は', '言う', 'に', '事欠く', 'dis']
さあ さあ 始まりました ヒステリックナイト | ['さあ', 'さあ', '始まる', 'ます', 'た', 'ヒステリックナイト']
今宵も rallyが続くでしょう | ['今宵', 'も', 'rally', 'が', '続く', 'です', 'う']
どう どう 御す間も無いわ 平手打ち | ['どう', 'どう', '御', 'す', '間', 'も', '無い', 'わ', '平手打ち']
Judgeは不在のfightが幕開けた | ['Judge', 'は', '不在', 'の', 'fight', 'が', '幕', '開ける', 'た']
一回くらいアタシの話も聞いて頂戴よ | ['一', '回', 'くらい', 'アタシ', 'の', '話', 'も', '聞く', 'て', '頂戴', 'よ']
なんてったって 突っ立ってんなって | ['なん', 'てる', 'たって', '突っ', '立つ', 'て', 'ん', 'なる', 'て']

134: God-ish | PinocchioP
(Oh my god) | ['(', 'Oh', 'm', 'y', 'god', ')']
愛のネタバレ「別れ」っぽいな | ['愛', 'の', 'ネタ', 'バレる', '「', '別れ', '」', 'っぽい', 'な']
人生のネタバレ「死ぬ」っぽいな | ['人生', 'の', 'ネタ', 'バレる', '「', '死ぬ', '」', 'っぽい', 'な']
なにそれ意味深でかっこいいじゃん | ['なに', 'それ', '意味', '深い', 'だ', 'かっこいい', 'じゃん']
それっぽい単語集で踊ってんだ 失敬 | ['それ', 'っぽい', '単語', '集', 'で', '踊る', 'て', 'ん', 'だ', '失敬']
とぅ とぅる とぅ とぅ とぅる 風 | ['と', 'ぅ', 'と', 'ぅる', 'と', 'ぅ', 'と', 'ぅ', 'と', 'ぅる', '風']
とぅ とぅる とぅ とぅ とぅる 風 | ['と', 'ぅ', 'と', 'ぅる', 'と', 'ぅ', 'と', 'ぅ', 'と', 'ぅる', '風']
とぅ とぅる とぅ とぅ とぅる 風 | ['と', 'ぅ', 'と', 'ぅる', 'と', 'ぅ', 'と', 'ぅ', 'と', 'ぅる', '風']
ぽいじゃん ぽいじゃん | ['ぽい', 'じゃん', 'ぽい', 'じゃん']
とぅ とぅる とぅ とぅ とぅる 風 | ['と', 'ぅ', 'と', 'ぅる', 'と', 'ぅ', 'と', 'ぅ', 'と', 'ぅる', '風']
とぅ とぅる とぅ とぅ とぅる 風 | ['と', 'ぅ', 'と', 'ぅる', 'と', 'ぅ', 'と', 'ぅ', 'と', 'ぅる', '風']
とぅ とぅる とぅ とぅ とぅる | ['と', 'ぅ', 'と', 'ぅる', 'と', 'ぅ', 'と', 'ぅ', 'と', 'ぅる']
神っぽいな | ['神', 'っぽい', 'な']
もういいぜ もういいぜ それ | ['もう', 'いい', 'ぜ', 'もう', 'いい', 'ぜ', 'それ']
もういいぜ もういいぜ 逆に興奮してきたなあ | ['もう', 'いい', 'ぜ', 'もう', 'いい', 'ぜ', '逆', 'に', '興奮', 'する', 'て', 'くる', 'た', 'なあ']
おっきいね おっきいね 夢 | ['おっきい', 'ね', 'おっきい', 'ね', '夢']
おっきいね おっきいね | ['おっきい', 'ね', 'おっきい', 'ね']
景気いいけど 品性は The end | ['景気', 'いい', 'けど', '品性', 'は', 'The', 'end']
うええい うええい | ['う', 'ええい', 'う', 'ええい']
(Gott ist tot) | ['(', 'Gott', 'ist', 'tot', ')']
神っぽいな それ 卑怯 | ['神', 'っぽい', 'な', 'それ', '卑怯']
神っぽいな それ (My God) | ['神', 'っぽい', 'な', 'それ', '(', 'M', 'y', 'God', ')']
アイウォンチュー ウォンチュー | ['アイウォンチュー', 'ウォンチュー']
IQが下がっていく感じ | ['IQ', 'が', '下がる', 'て', 'いく', '感じ']
邪心ぽいな それ 畢竟 | ['邪心', 'ぽい', 'な', 'それ', '畢竟']
邪心ぽいな それ (My God) | ['邪心', 'ぽい', 'な', 'それ', '(', 'M', 'y', 'God', ')']
アイヘイチュー ヘイチュー 害虫はどっち | ['アイヘイチュー', 'ヘイチュー', '害虫', 'は', 'どっち']
その髪型 その目 その口元 | ['その', '髪型', 'その', '目', 'その', '口元']
その香水 その服 そのメイク | ['その', '香水', 'その', '服', 'その', 'メイク']
アレっぽいな それ 比況 アレっぽいな それ | ['アレ', 'っぽい', 'な', 'それ', '比況', 'アレ', 'っぽい', 'な', 'それ']

135: 踊 | Ado
半端なら KO ふわふわ したいならどうぞ | ['半端', 'だ', 'KO', 'ふわふわ', 'する', 'たい', 'だ', 'どうぞ']
開演準備しちゃおうか | ['開演', '準備', 'する', 'ちゃう', 'う', 'か']
泣いても 笑っても 愛してね | ['泣く', 'て', 'も', '笑う', 'て', 'も', '愛す', 'て', 'ね']
ほら say "no" 低音響かせろ (Giga, TeddyLoid) | ['ほら', 'say', '"', 'n', 'o', '"', '低音', '響かせる', '(', 'Giga', ',', 'TeddyLoid', ')']
なんだかなってつまんないこともあるでしょう | ['なんだか', 'なる', 'て', 'つまんない', 'こと', 'も', 'ある', 'です', 'う']
ロンリー論理のノート ハンディー本気脱走 | ['ロンリー', '論理', 'の', 'ノート', 'ハンディー', '本気', '脱走']
やんなっちゃって泥に bad ご法度だろうが溺れて堕ちて | ['やる', 'なる', 'ちゃう', 'て', '泥', 'に', 'bad', 'ご法度', 'だ', 'う', 'が', '溺れる', 'て', '堕ちる', 'て']
そろそろいっか | ['そろそろ', 'いっか']
もっと頑張って アガるまでもっと頑張って | ['もっと', '頑張る', 'て', 'アガる', 'まで', 'もっと', '頑張る', 'て']
繋がろうひとりよりふたり 増えたら安心 心配ないや | ['繋がる', 'う', 'ひとり', 'より', 'ふたり', '増える', 'た', '安心', '心配', 'ない', 'や']
Alright 任せて don't mind | ['Alright', '任せる', 'て', 'don', "'", 't', 'mind']
波あり難題 みんなで乗っかっちゃえば | ['波', 'ある', '難題', 'みんな', 'で', '乗っかる', 'ちゃう', 'ば']
案外さくっと行っちゃいそう | ['案外', 'さくっと', '行く', 'ちゃう', 'そう']
半端なら KO ふわふわ したいならどうぞ | ['半端', 'だ', 'KO', 'ふわふわ', 'する', 'たい', 'だ', 'どうぞ']
開演準備しちゃおうか | ['開演', '準備', 'する', 'ちゃう', 'う', 'か']

136: アイドル | YOASOBI
無敵の笑顔で荒らすメディア | ['無敵', 'の', '笑顔', 'で', '荒らす', 'メディア']
知りたいその秘密ミステリアス | ['知る', 'たい', 'その', '秘密', 'ミステリアス']
抜けてるとこさえ彼女のエリア | ['抜ける', 'てる', 'とこ', 'さえ', '彼女', 'の', 'エリア']
完璧で嘘つきな君は | ['完璧', 'で', '嘘つき', 'だ', '君', 'は']
天才的なアイドル様 | ['天才', '的', 'だ', 'アイドル', '様']
(You're my savior, you're my saving grace) | ['(', 'You', "'", 'r', 'e', 'm', 'y', 'savior', ',', 'you', "'", 'r', 'e', 'm', 'y', 'saving', 'grace', ')']
今日何食べた？ | ['今日', '何', '食べる', 'た', '?']
好きな本は？ | ['好き', 'だ', '本', 'は', '?']
遊びに行くならどこに行くの？ | ['遊び', 'に', '行く', 'だ', 'どこ', 'に', '行く', 'の', '?']
何も食べてない | ['何', 'も', '食べる', 'てる', 'ない']
それは内緒 | ['それ', 'は', '内緒']
何を聞かれても | ['何', 'を', '聞く', 'れる', 'て', 'も']
のらりくらり | ['のらりくらり']
そう淡々と | ['そう', '淡々', 'と']
だけど燦々と | ['だけど', '燦々', 'と']
見えそうで見えない秘密は蜜の味 | ['見える', 'そう', 'だ', '見える', 'ない', '秘密', 'は', '蜜', 'の', '味']
あれもないないない | ['あれ', 'も', 'ない', 'ない', 'ない']
これもないないない | ['これ', 'も', 'ない', 'ない', 'ない']
好きなタイプは？ | ['好き', 'だ', 'タイプ', 'は', '?']
相手は？ | ['相手', 'は', '?']
さあ答えて | ['さあ', '答える', 'て']
「誰かを好きになることなんて私分からなくてさ」 | ['「', '誰', 'か', 'を', '好き', 'に', 'なる', 'こと', 'なんて', '私', '分かる', 'ない', 'て', 'さ', '」']
嘘か本当か知り得ない | ['嘘', 'か', '本当', 'か', '知る', '得る', 'ない']
そんな言葉にまた一人堕ちる | ['そんな', '言葉', 'に', 'また', '一', '人', '堕ちる']
また好きにさせる | ['また', '好き', 'に', 'する', 'せる']

137: Demon dance tokyo | Eve
ああ地元が恋しくない？ | ['ああ', '地元', 'が', '恋しい', 'ない', '?']
それにアソコの記憶も fly, far away | ['それに', 'アソコ', 'の', '記憶', 'も', 'fly', ',', 'far', 'away']
てくてくてくてく記録を付けてくよ | ['てくてく', 'てくてく', '記録', 'を', '付ける', 'て', 'く', 'よ']
インスタパラダイストーキョー | ['インスタパラダイストーキョー']
もの珍しいスタイルの人類を選別 | ['もの珍しい', 'スタイル', 'の', '人類', 'を', '選別']
羨ましいな 混ざりたいな | ['羨ましい', 'な', '混ざる', 'たい', 'な']
資格なんて気にせず just give me | ['資格', 'なんて', '気', 'に', 'する', 'ぬ', 'just', 'give', 'm', 'e']
スーパーモデルとデートがしたいな | ['スーパー', 'モデル', 'と', 'デート', 'が', 'する', 'たい', 'な']
カメラに収めていく | ['カメラ', 'に', '収める', 'て', 'いく']
スタイルをちょうだいな | ['スタイル', 'を', 'ちょうだい', 'な']
声までビューティフォサウンズアイラビンニッ | ['声', 'まで', 'ビューティフォサウンズアイラビンニッ']
ありのままの形で | ['ありのまま', 'の', '形', 'で']
やれるなら勝負して | ['やれる', 'だ', '勝負', 'する', 'て']
はらぺこ | ['はる', 'ぺこ']
できるだけ周到に | ['できるだけ', '周到', 'に']
たいらげる | ['たいらげる']
棘も毒もみんな味わって | ['棘', 'も', '毒', 'も', 'みんな', '味わう', 'て']
ひとつずついただきますって(笑) | ['ひとつ', 'ずつ', 'いただく', 'ます', 'って', '(', '笑', ')']
荒んじまえ | ['荒む', 'じまう']
翌日のアフターバッド | ['翌日', 'の', 'アフターバッド']
こけちまえ | ['こける', 'ちまう']
しゃしゃり出た印象で | ['しゃしゃり出る', 'た', '印象', 'で']
おさかなくわえて曲り角 of the dead | ['お', 'さかな', 'くわえる', 'て', '曲り角', 'o', 'f', 'the', 'dead']
最初から全部丸め込むなよ | ['最初', 'から', '全部', '丸め込む', 'な', 'よ']
心を | ['心', 'を']

138: Ibara | Ado
そのいばらで 願いを一つ叶えてくれよ | ['その', 'いばら', 'で', '願い', 'を', '一つ', '叶える', 'て', 'くれる', 'よ']
もう この甘ったれた 浅い眠りに傷をつけてさ | ['もう', 'この', '甘ったれる', 'た', '浅い', '眠り', 'に', '傷', 'を', 'つける', 'て', 'さ']
期待を超えるその魅惑の痛みで | ['期待', 'を', '超える', 'その', '魅惑', 'の', '痛み', 'で']
きっと 今よりずっと朝が見えるはず | ['きっと', '今', 'より', 'ずっと', '朝', 'が', '見える', 'はず']
ナナナ ナ ナ ナ | ['ナナナ', 'ナ', 'ナ', 'ナ']
反論などいらない | ['反論', 'など', 'いる', 'ない']
願ってしまったあなたの負けさ | ['願う', 'て', 'しまう', 'た', 'あなた', 'の', '負ける', 'さ']
長い眠りの旅の始まりだ | ['長い', '眠り', 'の', '旅', 'の', '始まり', 'だ']
つまりそう | ['つまり', 'そう']
生の尽きる果てに | ['生', 'の', '尽きる', '果て', 'に']
震えてしまったあなたの負けさ | ['震える', 'て', 'しまう', 'た', 'あなた', 'の', '負ける', 'さ']
それはすでにあなたに芽生えてる | ['それ', 'は', 'すでに', 'あなた', 'に', '芽生える', 'てる']
それはね しってる？ | ['それ', 'はねる', 'しる', 'てる', '?']
あなたのその眠りから生まれる | ['あなた', 'の', 'その', '眠り', 'から', '生まれる']
バクも吐き出す 鋭い希望 | ['バク', 'も', '吐き出す', '鋭い', '希望']
そのいばらで 願いを一つ叶えてくれよ | ['その', 'いばら', 'で', '願い', 'を', '一つ', '叶える', 'て', 'くれる', 'よ']

139: Aisai | Eve
相容れぬことで縛って | ['相', '容れる', 'ぬ', 'こと', 'で', '縛る', 'て']
最果ての奥に閉まって | ['最果て', 'の', '奥', 'に', '閉まる', 'て']
哀なものだとわかって | ['哀', 'だ', 'もの', 'だ', 'と', 'わかる', 'て']
優越に知りたいを重ねた | ['優越', 'に', '知る', 'たい', 'を', '重ねる', 'た']
泣いたりしたこともあって | ['泣く', 'たり', 'する', 'た', 'こと', 'も', 'ある', 'て']
暗い足元も見えないでいて | ['暗い', '足元', 'も', '見える', 'ない', 'で', 'いる', 'て']
今はまだ飛べるよう 愛憎感にしまった | ['今', 'は', 'まだ', '飛べる', 'よう', '愛憎', '感', 'に', 'しまう', 'た']
あの日のことも | ['あの', '日', 'の', 'こと', 'も']
言葉ではなんとも無いって | ['言葉', 'で', 'は', 'なんとも', '無い', 'って']
言葉ではなんとも無いって | ['言葉', 'で', 'は', 'なんとも', '無い', 'って']
言葉ではなんとも無いって | ['言葉', 'で', 'は', 'なんとも', '無い', 'って']
君と居よう | ['君', 'と', '居る', 'う']
藍才も捨ていけ 揺蕩う世を | ['藍', '才', 'も', '捨てる', 'いける', '揺', '蕩', 'う', '世', 'を']
君を辿る 寄る辺にも | ['君', 'を', '辿る', '寄る辺', 'に', 'も']
また少し違っていたのかな | ['また', '少し', '違う', 'て', 'いる', 'た', 'の', 'か', 'な']
終わることのなき旅路を | ['終わる', 'こと', 'の', 'ない', '旅路', 'を']

140: ばかじゃないのに | ZUTOMAYO
これは 二十歳じゃない | ['これ', 'は', '二', '十', '歳', 'じゃ', 'ない']
作業着 剥ぎ取っても | ['作業', '着', '剥ぐ', '取る', 'て', 'も']
まだ お線香の匂い 床に寝そべってた | ['まだ', 'お', '線香', 'の', '匂い', '床', 'に', '寝そべる', 'てる', 'た']
一丁前に回り回る 扇風機に嘆いてた | ['一', '丁', '前', 'に', '回る', '回る', '扇風機', 'に', '嘆く', 'てる', 'た']
ふと 会えない人を 思い浮かべてた | ['ふと', '会える', 'ない', '人', 'を', '思い浮かべる', 'てる', 'た']
急な矛盾が 飼い慣らせない | ['急', 'だ', '矛盾', 'が', '飼う', '慣らせる', 'ない']
誰のせいって わけじゃない | ['誰', 'の', 'せい', 'って', 'わけ', 'じゃ', 'ない']
色の濃い野菜ばっかり 湯掻いてた | ['色', 'の', '濃い', '野菜', 'ばっかり', '湯掻く', 'てる', 'た']
鮮やかな仕草に 混ざりたいのに | ['鮮やか', 'だ', '仕草', 'に', '混ざる', 'たい', 'のに']
声があるのに いつもどうして | ['声', 'が', 'ある', 'のに', 'いつも', 'どうして']
言っとけばいいのに ばかじゃないのに | ['言う', 'とく', 'ば', 'いい', 'のに', 'ばか', 'じゃ', 'ない', 'のに']
在り来りだろうけど | ['在り来り', 'だ', 'う', 'けど']
僕には 君を思い返す日々で過ごしていける？ | ['僕', 'に', 'は', '君', 'を', '思い返す', '日々', 'で', '過ごす', 'て', 'いける', '?']
もう居ないのに 惹かれ合うのに | ['もう', '居る', 'ない', 'のに', '惹く', 'れる', '合う', 'のに']
一瞬の夏だったよ | ['一瞬', 'の', '夏', 'だ', 'た', 'よ']
ありがとう | ['ありがとう']
僕に残ってる 引き摺る温もり | ['僕', 'に', '残る', 'てる', '引き摺る', '温もり']
ずっと まだ目の前に | ['ずっと', 'まだ', '目', 'の', '前', 'に']

141: Caffeine | Kiro Akiyama
Na, na na, na na na na | ['N', 'a', ',', 'n', 'a', 'n', 'a', ',', 'n', 'a', 'n', 'a', 'n', 'a', 'n', 'a']
もう何回うずくまってしまったか | ['もう', '何', '回', 'うずくまる', 'て', 'しまう', 'た', 'か']
覚えていない位には | ['覚える', 'て', 'いる', 'ない', '位', 'に', 'は']
切ない匂い 覚え過ぎたんだ | ['切ない', '匂い', '覚える', '過ぎる', 'た', 'ん', 'だ']
排水口 なだれ込んだ心の中身達 | ['排水', '口', 'なだれ込む', 'だ', '心', 'の', '中身', '達']
シンクにレモネード 零した次の夜が | ['シンク', 'に', 'レモネード', '零す', 'た', '次', 'の', '夜', 'が']
目を閉じ 開けた時には | ['目', 'を', '閉じる', '開ける', 'た', '時', 'に', 'は']
すぐ傍まで顔を見せている | ['すぐ', '傍', 'まで', '顔', 'を', '見せる', 'て', 'いる']
叶わない思いの類が | ['叶う', 'ない', '思い', 'の', '類', 'が']
バスルームのノブを落として | ['バス', 'ルーム', 'の', 'ノブ', 'を', '落とす', 'て']

142: slash | yama
正しい引き金を引いて | ['正しい', '引き金', 'を', '引く', 'て']
らしくない感情のお前が嫌いだ | ['らしい', 'ない', '感情', 'の', 'お前', 'が', '嫌い', 'だ']
つまらないものばかり追って | ['つまらない', 'もの', 'ばかり', '追って']
物陰に潜める | ['物陰', 'に', '潜める']
悲しい言い訳をして いつも | ['悲しい', '言い訳', 'を', 'する', 'て', 'いつも']
ヒロインを演じてるお前を憎んだ | ['ヒロイン', 'を', '演じる', 'てる', 'お前', 'を', '憎む', 'だ']
涙なんて性に合わないだろう | ['涙', 'なんて', '性', 'に', '合う', 'ない', 'だ', 'う']
鏡に映る本当の | ['鏡', 'に', '映る', '本当', 'の']
何も成せないままの僕に | ['何', 'も', '成す', 'ない', 'まま', 'の', '僕', 'に']
終止符を打った | ['終止符', 'を', '打つ', 'た']
最初から ずっと 流れ彷徨い | ['最初', 'から', 'ずっと', '流れ', '彷徨く']
喧騒 円状に僕を取り囲んで | ['喧騒', '円', '状', 'に', '僕', 'を', '取り囲む', 'で']
寂しいとか きっと 分かっていたんだ | ['寂しい', 'とか', 'きっと', '分かる', 'て', 'いたむ', 'だ']
お別れする | ['お', '別れ', 'する']
いつからか ずっと 見上げる空は | ['いつか', 'ら', 'か', 'ずっと', '見上げる', '空', 'は']

143: Just Awake | Fear, and Loathing in Las Vegas
重なってた胸の音 | ['重なる', 'てる', 'た', '胸', 'の', '音']
揺さぶっても聴こえない | ['揺さぶる', 'て', 'も', '聴こえる', 'ない']
こぼれ落ちたピース | ['こぼれ落ちる', 'た', 'ピース']
こんな日常の憂鬱さえ | ['こんな', '日常', 'の', '憂鬱', 'さえ']
ため息も出ずに無感情な僕ら | ['ため息', 'も', '出る', 'ぬ', 'に', '無', '感情', 'だ', '僕ら']
Life filled with vanity | ['Life', 'filled', 'with', 'vanity']
Colors have faded | ['Colors', 'have', 'faded']
Things you desire exist here | ['Things', 'you', 'desire', 'exist', 'here']
Flee from this colorless world | ['Flee', 'from', 'this', 'colorless', 'world']
つぎはぎの心は不安定 | ['つぎ', 'はぎの', '心', 'は', '不安定']
洗い流された初期衝動を 呼び覚まして走り出せ | ['洗い流す', 'れる', 'た', '初期', '衝動', 'を', '呼び覚ます', 'て', '走り出せる']
拙い言葉 思うままに繋ぐよ あの日の鼓動 | ['拙い', '言葉', '思う', 'まま', 'に', '繋ぐ', 'よ', 'あの', '日', 'の', '鼓動']
忘れないで | ['忘れる', 'ない', 'で']
Oh my lord, it's gone!! | ['Oh', 'm', 'y', 'lord', ',', 'it', "'", 's', 'gone', '!', '!']
What shall I do? | ['What', 'shall', 'I', 'do', '?']
Pieces I had have fell apart | ['Pieces', 'I', 'had', 'have', 'fell', 'apart']
Where do you belong? | ['Where', 'd', 'o', 'you', 'belong', '?']
Where should I aim? | ['Where', 'should', 'I', 'aim', '?']

144: departure!(TVサイズ) | Masatoshi Ono
大地を踏みしめて | ['大地', 'を', '踏みしめる', 'て']
君は目覚めていく | ['君', 'は', '目覚める', 'て', 'いく']
天使の微笑みで | ['天使', 'の', '微', '笑み', 'で']
連れ出して! | ['連れ出す', 'て', '!']
孤独でも 一人じゃないさ | ['孤独', 'でも', '一', '人', 'じゃ', 'ない', 'さ']

145: Oddloop | frederic
踊ってるだけで退場 | ['踊る', 'てる', 'だけ', 'で', '退場']
それをそっかそっかっていって | ['それ', 'を', 'そっ', 'か', 'そっ', 'か', 'って', 'いう', 'て']
お幸せについて討論 | ['お幸せ', 'について', '討論']
何が正義なんかって思う | ['何', 'が', '正義', 'なんか', 'って', '思う']
生意気そうにガム噛んで | ['生意気', 'そう', 'に', 'ガム', '噛む', 'で']
それもいいないいなって思う | ['それ', 'も', 'いい', 'な', 'いう', 'なる', 'て', '思う']
テレスコープ越しの感情 | ['テレ', 'スコープ', '越し', 'の', '感情']
ロッカーに全部詰め込んだ | ['ロッカー', 'に', '全部', '詰め込む', 'だ']
踊ってない夜を知らない | ['踊る', 'てる', 'ない', '夜', 'を', '知る', 'ない']
踊ってない夜が気に入らない | ['踊る', 'てる', 'ない', '夜', 'が', '気に入る', 'ない']
踊ってない夜を知らない | ['踊る', 'てる', 'ない', '夜', 'を', '知る', 'ない']
踊ってない夜が気に入らないよ | ['踊る', 'てる', 'ない', '夜', 'が', '気に入る', 'ない', 'よ']
気に入らない夜なんてもう僕は知らない | ['気に入る', 'ない', '夜', 'なんて', 'もう', '僕', 'は', '知る', 'ない']
踊ってない夜がない夜なんて | ['踊る', 'てる', 'ない', '夜', 'が', 'ない', '夜', 'なんて']
とってもとっても退屈です | ['とっても', 'とっても', '退屈', 'です']
思ってるだけで行動 | ['思う', 'てる', 'だけ', 'で', '行動']
きっとNight音楽も踊る | ['きっと', 'Night', '音楽', 'も', '踊る']

146: 死神 | Kenshi Yonezu
くだらねえ いつになりゃ終わる？ | ['くだる', 'ない', 'いつ', 'に', 'なる', '終わる', '?']
なんか死にてえ気持ちで ブラ ブラ ブラ | ['なんか', '死ぬ', 'て', 'え', '気持ち', 'で', 'ブラ', 'ブラ', 'ブラ']
残念 手前じゃ所在ねえ | ['残念', '手前', 'じゃ', '所在', 'ねえ']
アジャラカモクレン テケレッツのパー | ['アジャラカモクレン', 'テケレッツ', 'の', 'パー']
うぜえ じゃらくれたタコが | ['う', 'ぜ', 'え', 'じゃ', 'ら', 'くれる', 'た', 'タコ', 'が']
やってらんねえ 与太吹きブラ ブラ ブラ | ['やる', 'て', 'らん', 'ねえ', '与太', '吹く', 'ブラ', 'ブラ', 'ブラ']
悪銭 抱えどこへ行く | ['悪銭', '抱え', 'どこ', 'へ', '行く']
アジャラカモクレン テケレッツのパー | ['アジャラカモクレン', 'テケレッツ', 'の', 'パー']
Yeah, yeah | ['Yeah', ',', 'yeah']
Please, please help me | ['Please', ',', 'please', 'help', 'm', 'e']
ちっとこんがらがって 目が眩んだだけなんだわ | ['ちっと', 'こんがらがる', 'て', '目', 'が', '眩む', 'だ', 'だけ', 'だ', 'ん', 'だ', 'わ']
Yeah, yeah | ['Yeah', ',', 'yeah']
Please, please help me | ['Please', ',', 'please', 'help', 'm', 'e']
そんなけったいなことばっか言わんで容赦したってや | ['そんな', 'けったい', 'だ', 'こと', 'ばっか', '言う', 'んで', '容赦', 'する', 'た', 'って', 'や']
あぁ 火が消える 火が 火が消える | ['あぁ', '火', 'が', '消える', '火', 'が', '火', 'が', '消える']
夜明けを待たず | ['夜明け', 'を', '待つ', 'ぬ']
（あちゃちゃちゃちゃちゃちゃ） | ['(', 'あ', 'ちゃち', 'ゃちゃちゃちゃちゃ', ')']

147: Ai no Sukima | MIMI
だって答えが無いからさ | ['だって', '答え', 'が', '無い', 'から', 'さ']
瞳を閉じて時を見つめてた | ['瞳', 'を', '閉じる', 'て', '時', 'を', '見つめる', 'てる', 'た']
問いかける いつかの声 | ['問いかける', 'いつか', 'の', '声']
形無く漂った隠した 寂しさが | ['形', '無い', '漂う', 'た', '隠す', 'た', '寂しい', 'さ', 'が']
今日も降らした 涙と巡る輝きに | ['今日', 'も', '降らす', 'た', '涙', 'と', '巡る', '輝き', 'に']
儚いこの日を 名付けたくはなかったんだ | ['儚い', 'この', '日', 'を', '名付ける', 'たい', 'は', 'ない', 'た', 'ん', 'だ']
手探りで探してる 遠くを流れて征く明日へ | ['手探り', 'で', '探す', 'てる', '遠く', 'を', '流れる', 'て', '征', 'く', '明日', 'へ']
言葉を重ねる 心が確かに在るだけ | ['言葉', 'を', '重ねる', '心', 'が', '確か', 'に', '在る', 'だけ']
ああ | ['ああ']
無限の過去の色が | ['無限', 'の', '過去', 'の', '色', 'が']

148: Always with Me | Yumi Kimura
呼んでいる 胸のどこか奥で | ['呼ぶ', 'で', 'いる', '胸', 'の', 'どこ', 'か', '奥', 'で']
いつも心踊る 夢を見たい | ['いつも', '心', '踊る', '夢', 'を', '見る', 'たい']
かなしみは 数えきれないけれど | ['かなしみ', 'は', '数える', 'きれる', 'ない', 'けれど']
その向こうできっと あなたに会える | ['その', '向こう', 'で', 'きっと', 'あなた', 'に', '会える']
繰り返すあやまちの そのたび ひとは | ['繰り返す', 'あやまつ', 'の', 'その', 'たび', 'ひと', 'は']
ただ青い空の 青さを知る | ['ただ', '青い', '空', 'の', '青い', 'さ', 'を', '知る']
果てしなく 道は続いて見えるけれど | ['果てしない', '道', 'は', '続く', 'て', '見える', 'けれど']
この両手は 光を抱ける | ['この', '両手', 'は', '光', 'を', '抱ける']
さよならのときの 静かな胸 | ['さよなら', 'の', 'とき', 'の', '静か', 'だ', '胸']
ゼロになるからだが 耳をすませる | ['ゼロ', 'に', 'なる', 'から', 'だ', 'が', '耳', 'を', 'すませる']
生きている不思議 死んでいく不思議 | ['生きる', 'て', 'いる', '不思議', '死ぬ', 'で', 'いく', '不思議']

149: 憧れのままに | yama
ただ悠然と掴んだ吊り革とダンスして | ['ただ', '悠然と', '掴む', 'だ', '吊り革', 'と', 'ダンス', 'する', 'て']
次の駅で降りてったブレザー | ['次', 'の', '駅', 'で', '降りる', 'て', 'く', 'た', 'ブレザー']
眩しくて仕方ないな | ['眩しい', 'て', '仕方', 'ない', 'な']
いま 不安定な宇宙を歩いてかなくちゃね | ['いま', '不安定', 'だ', '宇宙', 'を', '歩く', 'て', 'く', 'ない', 'ちゃ', 'ね']
船から離れないためのロープ | ['船', 'から', '離れる', 'ない', 'ため', 'の', 'ロープ']
僕も握り直すよ | ['僕', 'も', '握る', '直す', 'よ']
子供みたいに拾い集めてきた空想 | ['子供', 'みたい', 'に', '拾う', '集める', 'て', 'くる', 'た', '空想']
心の骨 探している 星の海で | ['心', 'の', '骨', '探す', 'て', 'いる', '星', 'の', '海', 'で']
僕らがずっと抱いてきたあこがれのままに | ['僕ら', 'が', 'ずっと', '抱く', 'て', 'くる', 'た', 'あこがれ', 'の', 'まま', 'に']

150: 絶頂讃歌 | 和ぬか
ほとばしく香る君のその髪が | ['ほとばしる', 'くる', '香る', '君', 'の', 'その', '髪', 'が']
僕の心を踊らせたんです | ['僕', 'の', '心', 'を', '踊る', 'せる', 'た', 'ん', 'です']
靡くだけ 今は それだけで | ['靡く', 'だけ', '今', 'は', 'それ', 'だけ', 'だ']
この身 屈めますから | ['この', '身', '屈める', 'ます', 'から']
(Hey, hey, hey!) | ['(', 'Hey', ',', 'hey', ',', 'hey', '!', ')']
Midnight光線Darling | ['Midnight', '光線', 'Darling']
堪えきれぬ欲望に任せて | ['堪える', 'きれる', 'ぬ', '欲望', 'に', '任せる', 'て']
Midnight光線Darling | ['Midnight', '光線', 'Darling']
僕に仕える気になったら | ['僕', 'に', '仕える', '気', 'に', 'なる', 'た']
あぁ 願うは三度の絶頂を | ['あぁ', '願う', 'は', '三', '度', 'の', '絶頂', 'を']
胸の中で至る | ['胸', 'の', '中', 'で', '至る']
今宵も僕らは繁栄の | ['今宵', 'も', '僕ら', 'は', '繁栄', 'の']
ために愛を放つ | ['ため', 'に', '愛', 'を', '放つ']
抗いの呟きとは裏腹に | ['抗う', 'の', '呟く', 'と', 'は', '裏腹', 'に']

None type
152: Rasen | jon-YAKITORY
なんで どうして | ['なんで', 'どうして']
この孤独は | ['この', '孤独', 'は']
誰にとって必要なの？ | ['誰', 'にとって', '必要', 'だ', 'の', '?']
明日を見上げる首は | ['明日', 'を', '見上げる', '首', 'は']
いつか誰かに | ['いつか', '誰', 'か', 'に']
切り取られていた | ['切り取る', 'れる', 'て', 'いる', 'た']
大声で笑うことは | ['大声', 'で', '笑う', 'こと', 'は']
いつになれば | ['いつ', 'に', 'なる', 'ば']
許されるのかな | ['許す', 'れる', 'の', 'か', 'な']
もし今疲れ果てて | ['もし', '今', '疲れ', '果てる', 'て']
倒れたって誰も気付かない | ['倒れる', 'た', 'って', '誰', 'も', '気付く', 'ない']
今日は今日のまま | ['今日', 'は', '今日', 'の', 'まま']
お前らのせいだ | ['お前', 'ら', 'の', 'せい', 'だ']
お前らのせいだ | ['お前', 'ら', 'の', 'せい', 'だ']
あの記憶も | ['あの', '記憶', 'も']
この制裁も | ['この', '制裁', 'も']
お前らのせいだ | ['お前', 'ら', 'の', 'せい', 'だ']
お前らのせいだ | ['お前', 'ら', 'の', 'せい', 'だ']
言い訳なんて | ['言い訳', 'なんて']
聞きたくない | ['聞く', 'たい', 'ない']

153: アウトサイダー | Eve
ねえねえ この世界を どっかでひっくり返したくて | ['ねえ', 'ねえ', 'この', '世界', 'を', 'どっか', 'で', 'ひっくり返す', 'たい', 'て']
せいぜい 時間なんて ありはしないが | ['せいぜい', '時間', 'なんて', 'ある', 'は', 'する', 'ない', 'が']
まあまあ そんなんで 少年少女揃いまして | ['まあ', 'まあ', 'そんな', 'ん', 'だ', '少年', '少女', '揃う', 'ます', 'て']
唸り始めた会心劇さ | ['唸る', '始める', 'た', '会心', '劇', 'さ']
天才で人外で横暴が | ['天才', 'で', '人外', 'で', '横暴', 'が']
最低で最高な相棒さ | ['最低', 'で', '最高', 'だ', '相棒', 'さ']
単純で明快な考えが | ['単純', 'だ', '明快', 'だ', '考え', 'が']
僕をここで醒ましてくれないか | ['僕', 'を', 'ここ', 'で', '醒ます', 'て', 'くれる', 'ない', 'か']
今この身をもって 重石をとって | ['今', 'この', '身', 'を', 'もつ', 'て', '重石', 'を', 'とる', 'て']
君にだけにしかできない事はなんだ | ['君', 'に', 'だけ', 'に', 'しか', 'できる', 'ない', '事', 'は', 'なん', 'だ']
ここにいないでくれ | ['ここ', 'に', 'いる', 'ない', 'で', 'くれる']
慰めなんていらないよ | ['慰め', 'なんて', 'いる', 'ない', 'よ']
荒地になって しまわぬように | ['荒地', 'に', 'なる', 'て', 'しまう', 'ぬ', 'よう', 'に']
その名を隠してここに現れたのさ | ['その', '名', 'を', '隠す', 'て', 'ここ', 'に', '現れる', 'た', 'の', 'さ']
のさばってる奴らを | ['のさばる', 'てる', '奴ら', 'を']
探って抉って嗤っては泣いて | ['探る', 'て', '抉る', 'て', '嗤', 'って', 'は', '泣く', 'て']
ああ しょうもないな | ['ああ', 'しょうもない', 'な']

None type
None type
None type
157: Requiem | Kanaria
曖昧ディスコミュ | ['曖昧', 'ディスコミュ']
まるで狂気の花 | ['まるで', '狂気', 'の', '花']
泣きそうに悲しそうに | ['泣く', 'そう', 'に', '悲しい', 'そう', 'に']
あなたに伝えたい | ['あなた', 'に', '伝える', 'たい']
愛のRE:ラビュー | ['愛', 'の', 'RE', ':', 'ラビュー']
それは 魔法の言葉 | ['それ', 'は', '魔法', 'の', '言葉']
消えそうに優しそうに | ['消える', 'そう', 'に', '優しい', 'そう', 'に']
あなたに伝えた | ['あなた', 'に', '伝える', 'た']
幸せな蝶になったって | ['幸せ', 'だ', '蝶', 'に', 'なる', 'た', 'って']
瞬きで宙に頓挫して | ['瞬き', 'で', '宙', 'に', '頓挫', 'する', 'て']
ならば願い託して | ['ならば', '願い', '託す', 'て']
受けて止めて認めて | ['受ける', 'て', '止める', 'て', '認める', 'て']
揺れるファイヤー 叫ぶフライハイ | ['揺れる', 'ファイヤー', '叫ぶ', 'フライ', 'ハイ']
私染まれれば | ['私', '染む', 'れる', 'ば']
二人の幸せとか 積もる | ['二', '人', 'の', '幸せ', 'とか', '積もる']
情熱をあげるわ | ['情熱', 'を', 'あげる', 'わ']

158: Muchinnchi | jon-YAKITORY
あーそれね なるほどね | ['あー', 'それ', 'ね', 'なるほど', 'ね']
心ディフェンス バリバリア | ['心', 'ディフェンス', 'バリバリア']
それよりね あの人がねって | ['それ', 'より', 'ね', 'あの', '人', 'が', 'ねる', 'て']
お呼びじゃないのさ | ['お呼び', 'じゃ', 'ない', 'の', 'さ']
プライドなんてもんはどっか遠く投げ捨てて | ['プライド', 'なんて', 'もん', 'は', 'どっか', '遠い', '投げ捨てる', 'て']
頷くだけでそれでいいのだ | ['頷く', 'だけ', 'で', 'それ', 'で', 'いい', 'の', 'だ']
気取るだけでは何も生まれないさ | ['気取る', 'だけ', 'だ', 'は', '何', 'も', '生まれる', 'ない', 'さ']
せっせっせい | ['せる', 'せっせい']
I don't wanna say | ['I', 'don', "'", 't', 'wanna', 'say']

None type
160: Hello,world! | BUMP OF CHICKEN
扉開けば 捻れた昼の夜 | ['扉', '開く', 'ば', '捻れる', 'た', '昼', 'の', '夜']
昨日どうやって帰った 体だけが確か | ['昨日', 'どう', 'やる', 'て', '帰る', 'た', '体', 'だけ', 'が', '確か']
おはよう これからまた迷子の続き | ['おはよう', 'これから', 'また', '迷子', 'の', '続く']
見慣れた知らない 景色の中で | ['見慣れる', 'た', '知る', 'ない', '景色', 'の', '中', 'で']
もう駄目って思ってから わりと何だかやれている | ['もう', '駄目', 'って', '思う', 'て', 'から', 'わり', 'と', '何だか', 'やれる', 'て', 'いる']
死にきらないくらいに丈夫 何かちょっと恥ずかしい | ['死ぬ', 'きる', 'ない', 'くらい', 'に', '丈夫', '何', 'か', 'ちょっと', '恥ずかしい']
やるべきことは 忘れていても解る | ['やる', 'べし', 'こと', 'は', '忘れる', 'て', 'いる', 'て', 'も', '解る']
そうしないと とても苦しいから | ['そう', 'する', 'ない', 'と', 'とても', '苦しい', 'から']
顔を上げて 黒い目の人 | ['顔', 'を', '上げる', 'て', '黒い', '目', 'の', '人']
君が見たから 光は生まれた | ['君', 'が', '見る', 'た', 'から', '光', 'は', '生まれる', 'た']
選んだ色で塗った 世界に囲まれて | ['選ぶ', 'だ', '色', 'で', '塗る', 'た', '世界', 'に', '囲む', 'れる', 'て']
選べない傷の意味はどこだろう | ['選べる', 'ない', '傷', 'の', '意味', 'は', 'どこ', 'だ', 'う']
ご自分だけがヒーロー 世界の真ん中で | ['ご', '自分', 'だけ', 'が', 'ヒーロー', '世界', 'の', '真ん中', 'で']
終わるまで出突っ張り ステージの上 | ['終わる', 'まで', '出突っ張り', 'ステージ', 'の', '上']
どうしよう 空っぽのふりも出来ない | ['どう', 'する', 'う', '空っぽ', 'の', 'ふり', 'も', '出来る', 'ない']
ハロー どうも 僕はここ | ['ハロー', 'どうも', '僕', 'は', 'ここ']

161: 花の塔 | Sayuri
君が持ってきた漫画 | ['君', 'が', '持つ', 'て', 'くる', 'た', '漫画']
くれた知らない名前のお花 | ['くれる', 'た', '知る', 'ない', '名前', 'の', 'お', '花']
今日はまだ来ないかな？ | ['今日', 'は', 'まだ', '来る', 'ない', 'か', 'な', '?']
初めての感情知ってしまった | ['初めて', 'の', '感情', '知る', 'て', 'しまう', 'た']
窓に飾った絵画をなぞってひとりで宇宙を旅して | ['窓', 'に', '飾る', 'た', '絵画', 'を', 'なぞる', 'て', 'ひとり', 'で', '宇宙', 'を', '旅', 'する', 'て']
それだけでいいはずだったのに | ['それ', 'だけ', 'だ', 'いい', 'はず', 'だ', 'た', 'のに']
君の手を握ってしまったら | ['君', 'の', '手', 'を', '握る', 'て', 'しまう', 'た']
孤独を知らないこの街には | ['孤独', 'を', '知る', 'ない', 'この', '街', 'に', 'は']
もう二度と帰ってくることはできないのでしょう | ['もう', '二度と', '帰る', 'て', 'くる', 'こと', 'は', 'できる', 'ない', 'の', 'です', 'う']
君が手を差し伸べた 光で影が生まれる | ['君', 'が', '手', 'を', '差し伸べる', 'た', '光', 'で', '影', 'が', '生まれる']
歌って聞かせて この話の続き | ['歌う', 'て', '聞く', 'せる', 'て', 'この', '話', 'の', '続く']
連れて行って見たことない星まで | ['連れる', 'て', '行く', 'て', '見る', 'た', 'こと', 'ない', '星', 'まで']

162: 海のまにまに | YOASOBI
夜の合間を縫うように | ['夜', 'の', '合間', 'を', '縫う', 'よう', 'に']
走る電車の中ゆらり | ['走る', '電車', 'の', '中', 'ゆらり']
後ろ向きに流れる景色をひとり | ['後ろ向き', 'に', '流れる', '景色', 'を', 'ひとり']
座って 見ていた 見ていた | ['座る', 'て', '見る', 'て', 'いる', 'た', '見る', 'て', 'いる', 'た']
昼下がりの陽射しは | ['昼下がり', 'の', '陽射し', 'は']
夕陽のオレンジ色に染まって | ['夕陽', 'の', 'オレンジ', '色', 'に', '染まる', 'て']
藍色の空に押し潰されていく | ['藍色', 'の', '空', 'に', '押す', '潰す', 'れる', 'て', 'いく']
その最後の光を惜しむように | ['その', '最後', 'の', '光', 'を', '惜しむ', 'よう', 'に']
目で追いかけたのは | ['目', 'で', '追いかける', 'た', 'の', 'は']
今日で バイバイ だから | ['今日', 'で', 'バイバイ', 'だから']
明日を捨てる為に飛び出した逃避行 | ['明日', 'を', '捨てる', '為', 'に', '飛び出す', 'た', '逃避行']
片道分の切符で行けるとこまで行くの | ['片道', '分', 'の', '切符', 'で', '行ける', 'とこ', 'まで', '行く', 'の']
どこにも居場所なんて無い私をこのまま | ['どこ', 'に', 'も', '居場所', 'なんて', '無い', '私', 'を', 'この', 'まま']
夜に置いてって 置いてって | ['夜', 'に', '置く', 'て', 'く', 'て', '置く', 'て', 'く', 'て']
不意に窓から見えた景色が暗闇に | ['不意', 'に', '窓', 'から', '見える', 'た', '景色', 'が', '暗闇', 'に']
気付いたあれはそうだきっと夜の海 | ['気付く', 'た', 'あれ', 'は', 'そう', 'だ', 'きっと', '夜', 'の', '海']
出来心に手を引かれて降りた海辺の町 | ['出来心', 'に', '手', 'を', '引く', 'れる', 'て', '降りる', 'た', '海辺', 'の', '町']
波の音にただ導かれるように歩く | ['波', 'の', '音', 'に', 'ただ', '導く', 'れる', 'よう', 'に', '歩く']
誰かに呼ばれるように | ['誰', 'か', 'に', '呼ぶ', 'れる', 'よう', 'に']
近付いた海のほとり | ['近付く', 'た', '海', 'の', 'ほとり']
ここにはひとり | ['ここ', 'に', 'は', 'ひとり']

163: みちづれ | Hoshimachi Suisei
Hello, everybody | ['Hello', ',', 'everybody']
This is going to be a once-in-a-lifetime party | ['This', 'i', 's', 'going', 't', 'o', 'b', 'e', 'a', 'once', '-', 'in', '-', 'a', '-', 'lifetime', 'party']
Hey you, yes, it's you over there | ['H', 'e', 'y', 'you', ',', 'yes', ',', 'it', "'", 's', 'you', 'over', 'there']
With that heavy burden on your shoulders | ['With', 'that', 'heavy', 'burden', 'o', 'n', 'your', 'shoulders']
Excuse now, I wanna talk to you | ['Excuse', 'now', ',', 'I', 'wanna', 'talk', 't', 'o', 'you']
Why don't you come along with me? | ['Why', 'don', "'", 't', 'you', 'come', 'along', 'with', 'm', 'e', '?']
Here we go | ['Here', 'w', 'e', 'g', 'o']
人の世はいついつまでも | ['人', 'の', '世', 'は', 'いつく', 'つ', 'まで', 'も']
間違い探しばかり | ['間違い', '探す', 'ばかり']
遊び飽きたら終わりよ | ['遊び', '飽きる', 'た', '終わる', 'よ']
鬼が出るか蛇が出るかと | ['鬼', 'が', '出る', 'か', '蛇', 'が', '出る', 'か', 'と']
怯えて過ごすばかり | ['怯える', 'て', '過ごす', 'ばかり']
さめざめと一人泣く あぁ | ['さめざめ', 'と', '一', '人', '泣く', 'あぁ']
こんな旅路をゆくことが | ['こんな', '旅路', 'を', 'ゆく', 'こと', 'が']
人の条理とでも言うの | ['人', 'の', '条理', 'と', 'で', 'も', '言う', 'の']

164: Shirayuki | Eve
君と僕のこの合間には | ['君', 'と', '僕', 'の', 'この', '合間', 'に', 'は']
何光年分の距離があった | ['何', '光年', '分', 'の', '距離', 'が', 'ある', 'た']
白い息を吐きだす度 | ['白い', '息', 'を', '吐きだす', '度']
かじかんだ手が触れ合うような | ['かじかむ', 'だ', '手', 'が', '触れ合う', 'よう', 'だ']
こんなちぐはぐな感情 | ['こんな', 'ちぐはぐ', 'だ', '感情']
華やかな街路樹 横目に揺らいだ | ['華やか', 'だ', '街路', '樹', '横目', 'に', '揺らぐ', 'だ']
待ちきれぬ焦燥 急ぎ足だった | ['待つ', 'きれる', 'ぬ', '焦燥', '急ぎ足', 'だ', 'た']
ツンと冬の匂いがした今年も | ['ツン', 'と', '冬', 'の', '匂い', 'が', 'する', 'た', '今年', 'も']
いつも傍で感じていたい | ['いつも', '傍', 'で', '感じる', 'て', 'いる', 'たい']
大切にしまっていたい | ['大切', 'に', 'しまう', 'て', 'いる', 'たい']
優しさに溢れた 白雪な世界 | ['優しい', 'さ', 'に', '溢れる', 'た', '白', '雪', 'だ', '世界']
口が解ける 夢でもいいから | ['口', 'が', '解ける', '夢', 'でも', 'いい', 'から']

165: レンズ | Lilas Ikuta
一人歩く | ['一', '人', '歩く']
帰り道の途中 | ['帰り道', 'の', '途中']
イヤホンから伝うこの歌は | ['イヤ', 'ホン', 'から', '伝う', 'この', '歌', 'は']
二人だけの | ['二', '人', 'だけ', 'の']
夕映えに貴方が | ['夕映え', 'に', '貴方', 'が']
教えてくれた小さな幸せ | ['教える', 'て', 'くれる', 'た', '小さな', '幸せ']
見返す写真には少し見切れた | ['見返す', '写真', 'に', 'は', '少し', '見切れる', 'た']
後ろ姿の貴方が写っている | ['後ろ姿', 'の', '貴方', 'が', '写る', 'て', 'いる']
かざしたレンズのその先に | ['かざす', 'た', 'レンズ', 'の', 'その', '先', 'に']
ただ貴方がそこにいれば | ['ただ', '貴方', 'が', 'そこ', 'に', 'いる', 'ば']
華やいでいく心がここにあって | ['華やぐ', 'で', 'いく', '心', 'が', 'ここ', 'に', 'ある', 'て']
未だに私を離さない | ['未だに', '私', 'を', '離す', 'ない']

None type
167: アイタリナイ | MAISONdes
まだ足りない愛してたいやいや | ['まだ', '足りる', 'ない', '愛しい', 'てる', 'た', 'いやいや']
あなた以外考えられないや | ['あなた', '以外', '考える', 'られる', 'ない', 'や']
あたしを好いてあたしだけ見て | ['あたし', 'を', '好く', 'て', 'あたし', 'だけ', '見る', 'て']
もうあなたの髄まで愛してる | ['もう', 'あなた', 'の', '髄', 'まで', '愛す', 'てる']
瞳の奥底 | ['瞳', 'の', '奥底']
誰を待ってるの？ | ['誰', 'を', '待つ', 'てる', 'の', '?']
あなたは横顔しか | ['あなた', 'は', '横顔', 'しか']
見せてないわ | ['見せる', 'てる', 'ない', 'わ']
教えて欲しいの | ['教える', 'て', '欲しい', 'の']
Give me love, give me love だけ | ['Give', 'm', 'e', 'love', ',', 'give', 'm', 'e', 'love', 'だけ']
どんな惑星よりも | ['どんな', '惑星', 'より', 'も']
この地球上に | ['この', '地球', '上', 'に']
あなたがいたから | ['あなた', 'が', 'いる', 'た', 'から']
吸い落ちて来たの | ['吸う', '落ちる', 'て', '来る', 'た', 'の']
応えて欲しいの | ['応える', 'て', '欲しい', 'の']
曖昧を I need youを | ['曖昧', 'を', 'I', 'need', 'you', 'を']
アイタイ難解シタイ | ['アイタイ', '難解', 'シタイ']
愛シアイタイ | ['愛', 'シアイタイ']
ねぇねぇダーリンダーリン | ['ねぇ', 'ねぇ', 'ダーリン', 'ダーリン']
宇宙の果てまで | ['宇宙', 'の', '果て', 'まで']

None type
169: シャル・ウィ・ダンス？ | ReoNa
悲しみは笑いましょう | ['悲しみ', 'は', '笑う', 'ます', 'う']
生きるってmarionette | ['生きる', 'って', 'marionette']
心臓がスイングしたら | ['心臓', 'が', 'スイング', 'する', 'た']
珈琲はいかが？ | ['珈琲', 'は', 'いかが', '?']
Un, deux, deux, un, deux, deux | ['Un', ',', 'deux', ',', 'deux', ',', 'un', ',', 'deux', ',', 'deux']
Un, deux, deux, trois | ['Un', ',', 'deux', ',', 'deux', ',', 'trois']
私うまく踊れないわ | ['私', 'うまい', '踊れる', 'ない', 'わ']
痛みも 恨みも 悲しみも | ['痛み', 'も', '恨み', 'も', '悲しみ', 'も']
混ぜて（混ぜて）こねて（こねて） | ['混ぜる', 'て', '(', '混ぜる', 'て', ')', 'こねる', 'て', '(', 'こねる', 'て', ')']
おやすみのkiss | ['おやすみ', 'の', 'kiss']
Shall we dance? 踊りましょう | ['Shall', 'w', 'e', 'dance', '?', '踊る', 'ます', 'う']
絶望 欲望 this is the life! | ['絶望', '欲望', 'this', 'i', 's', 'the', 'life', '!']
Shadow life! | ['Shadow', 'life', '!']
余計なこと考えないで | ['余計', 'だ', 'こと', '考える', 'ない', 'で']
ひとつになりましょう | ['ひとつ', 'に', 'なる', 'ます', 'う']
いいな（いいな）いいな（いいな） | ['いい', 'な', '(', 'いい', 'な', ')', 'いい', 'な', '(', 'いい', 'な', ')']
人間って 人間って いいな | ['人間', 'って', '人間', 'って', 'いい', 'な']
La, la-la-la, la-la-la (Shadow! Shadow!) | ['La', ',', 'l', 'a', '-', 'l', 'a', '-', 'l', 'a', ',', 'l', 'a', '-', 'l', 'a', '-', 'l', 'a', '(', 'Shadow', '!', 'Shadow', '!', ')']
La, la-la-la, la-la-la | ['La', ',', 'l', 'a', '-', 'l', 'a', '-', 'l', 'a', ',', 'l', 'a', '-', 'l', 'a', '-', 'l', 'a']

170: 愛のけだもの | KAMI WA SAIKORO WO FURANAI
アイマイでギリギリな | ['アイマイ', 'で', 'ギリギリ', 'だ']
カンケイだって | ['カン', 'ケイ', 'だって']
名前がないだけの愛で | ['名前', 'が', 'ない', 'だけ', 'の', '愛', 'で']
逢いたくなるようじゃ | ['逢う', 'たい', 'なる', 'よう', 'じゃ']
しょうがないさ | ['しょうが', 'ない', 'さ']
心が酔い溶けて痛いよ | ['心', 'が', '酔う', '溶ける', 'て', '痛い', 'よ']
堕落の乾杯に我愛イ尓 | ['堕落', 'の', '乾杯', 'に', '我', '愛', 'イ', '尓']
甘い口づけに私 | ['甘い', '口づけ', 'に', '私']
また踊らされてゆく | ['また', '踊る', 'する', 'れる', 'て', 'ゆく']
あなたが汚して、濡らして | ['あなた', 'が', '汚す', 'て', '、', '濡らす', 'て']
傷をつけて | ['傷', 'を', 'つける', 'て']
ダメにしてしまった私を | ['ダメ', 'に', 'する', 'て', 'しまう', 'た', '私', 'を']
最後まで愛さなくてもかまわない | ['最後', 'まで', '愛す', 'ない', 'て', 'も', 'かまう', 'ない']
二人の動物がいるだけ | ['二', '人', 'の', '動物', 'が', 'いる', 'だけ']
ただ求め合って、奪い合って | ['ただ', '求める', '合う', 'て', '、', '奪い合う', 'て']
有耶無耶にして | ['有耶無耶', 'に', 'する', 'て']
虚しくなってしまうまで | ['虚しい', 'なる', 'て', 'しまう', 'まで']
何も知らないけだものみたいに | ['何', 'も', '知る', 'ない', 'け', 'だ', 'もの', 'みたい', 'に']
言葉を捨て | ['言葉', 'を', '捨てる']
ただひとつになっていたいよ | ['ただ', 'ひとつ', 'に', 'なる', 'て', 'いる', 'たい', 'よ']

171: osmanthus | whaledontsleep
今になって答え合わせ | ['今', 'に', 'なる', 'て', '答える', '合う', 'せる']
そんなのどうでも良くて | ['そんな', 'の', 'どう', 'でも', '良い', 'て']
憂いの波は寄せては返す | ['憂い', 'の', '波', 'は', '寄せる', 'て', 'は', '返す']
落ちてた吸殻はいて | ['落ちる', 'てる', 'た', '吸殻', 'は', 'いる', 'て']
地面に這った記憶を拾い集めてる | ['地面', 'に', '這う', 'た', '記憶', 'を', '拾う', '集める', 'てる']
味のないクッキーコインランドリー | ['味', 'の', 'ない', 'クッキーコインランドリー']
バカみたいなハンバーガー | ['バカ', 'みたい', 'だ', 'ハンバーガー']
落書きだらけの排気管 | ['落書き', 'だらけ', 'の', '排気', '管']

172: Paradisus-Paradoxum | MYTH & ROID
Now let me open the scar | ['Now', 'let', 'm', 'e', 'open', 'the', 'scar']
溶け合ったVirus 虹に黒を差し飛び立つ あぁ | ['溶け合う', 'た', 'Virus', '虹', 'に', '黒', 'を', '差す', '飛び立つ', 'あぁ']
赤い花の蜜 濡れて隠れたノイズ | ['赤い', '花', 'の', '蜜', '濡れる', 'て', '隠れる', 'た', 'ノイズ']
胸に這い寄るの「ウマレカワリタイノデショウ？」 | ['胸', 'に', '這う', '寄る', 'の', '「', 'ウマレカワリタイノデショウ', '?', '」']
永遠 眠っていたパラダイム | ['永遠', '眠る', 'て', 'いる', 'た', 'パラダイム']
芯を喰って侵食していた | ['芯', 'を', '喰う', 'て', '侵食', 'する', 'て', 'いる', 'た']
Now let me open the scar | ['Now', 'let', 'm', 'e', 'open', 'the', 'scar']
溶け合ったVirus 触れて 露わになる本能 | ['溶け合う', 'た', 'Virus', '触れる', 'て', '露', 'わに', 'なり', '本能']
Grew up in the loneliness | ['Grew', 'u', 'p', 'in', 'the', 'loneliness']
壊れたReality 虹に黒を差し飛び立つ あぁ | ['壊れる', 'た', 'Reality', '虹', 'に', '黒', 'を', '差す', '飛び立つ', 'あぁ']
今すぐ抜け出して 正気の迷路 | ['今', 'すぐ', '抜け出す', 'て', '正気', 'の', '迷路']
反転したコントラストへ | ['反転', 'する', 'た', 'コントラスト', 'へ']

173: ないない | ReoNa
灰のない 深い 影ばかり | ['灰', 'の', 'ない', '深い', '影', 'ばかり']
愛のない 答え ドールみたい | ['愛', 'の', 'ない', '答え', 'ドール', 'みたい']
自分 不在 どこにもいない | ['自分', '不在', 'どこ', 'に', 'も', 'いる', 'ない']
ない じゃない | ['ない', 'じゃ', 'ない']
曖昧な愛 色のない愛 | ['曖昧', 'だ', '愛', '色', 'の', 'ない', '愛']
期待 以外 他人事みたい | ['期待', '以外', '他', '人事', 'みたい']
お影様 どちら様 | ['お', '影', '様', 'どちら', '様']
応え様々 | ['応え', '様', '々']
何者でもないまま | ['何者', 'で', 'も', 'ない', 'まま']
何にもできないまま | ['何', 'に', 'も', 'できる', 'ない', 'まま']
生きるのは無駄ですか？ | ['生きる', 'の', 'は', '無駄', 'です', 'か', '?']
悪いことですか？ | ['悪い', 'こと', 'です', 'か', '?']
ここにいない いない いないのは | ['ここ', 'に', 'いる', 'ない', 'いる', 'ない', 'いる', 'ない', 'の', 'は']
自分 自分 | ['自分', '自分']
誰も見ない 見ない 見ないまま | ['誰', 'も', '見る', 'ない', '見る', 'ない', '見る', 'ない', 'まま']
掃き捨ててさようなら | ['掃く', '捨てる', 'て', 'さようなら']

174: Can Do | GRANRODEO
だから言ったじゃないか | ['だから', '言う', 'た', 'じゃ', 'ない', 'か']
弱さをウリにしたって前になんか進めやしないんだぜ | ['弱い', 'さ', 'を', 'ウリ', 'に', 'する', 'た', 'って', '前', 'に', 'なんか', '進める', 'やす', 'ない', 'ん', 'だ', 'ぜ']
ねぇ 儚い自分 | ['ねぇ', '儚い', '自分']
演出したって誰も無感動 | ['演出', 'する', 'た', 'って', '誰', 'も', '無', '感動']
孤独が苛む夜にだって明日待ちわびる光がある | ['孤独', 'が', '苛む', '夜', 'に', 'だって', '明日', '待ちわびる', '光', 'が', 'ある']
強がる弱い自分を認められる強さを | ['強がる', '弱い', '自分', 'を', '認める', 'られる', '強い', 'さ', 'を']
始めるんだ やれるモンさ | ['始める', 'ん', 'だ', 'やれる', 'モン', 'さ']
そこから前を 向いちゃって | ['そこ', 'から', '前', 'を', '向う', 'ちゃう', 'て']
歩け 走れ 何度でも | ['歩ける', '走れる', '何', '度', 'でも']
調子ハズレの声だっていいさ | ['調子', 'ハズレ', 'の', '声', 'だって', 'いい', 'さ']
それがどうしたんだって | ['それ', 'が', 'どう', 'する', 'た', 'ん', 'だって']
叫ぶんだ 俺の番だ Can you do it? | ['叫ぶ', 'ん', 'だ', '俺', 'の', '番', 'だ', 'Can', 'you', 'd', 'o', 'it', '?']
するとどうだろう何だって | ['すると', 'どう', 'だ', 'う', '何', 'だって']
怖くなんかなくなってんぜ | ['怖い', 'なんか', 'なくなる', 'てる', 'ぜ']
今日が我が身だ I can do it | ['今日', 'が', '我が身', 'だ', 'I', 'can', 'd', 'o', 'i', 't']
You can do it | ['You', 'can', 'd', 'o', 'i', 't']
We can do it | ['W', 'e', 'can', 'd', 'o', 'i', 't']
息が止まるほどの | ['息', 'が', '止まる', 'ほど', 'の']

175: EVERBLUE | Omoinotake
白む空に吐き出すため息は | ['白む', '空', 'に', '吐き出す', 'ため息', 'は']
無色透明でまるで空っぽみたい | ['無色', '透明', 'だ', 'まるで', '空っぽ', 'みたい']
ページをめくれば | ['ページ', 'を', 'めくる', 'ば']
景色を変えるノベル | ['景色', 'を', '変える', 'ノベル']
カレンダーめくっても | ['カレンダー', 'めくる', 'て', 'も']
変われもしない僕 | ['変わる', 'も', 'する', 'ない', '僕']
擦る臉 | ['擦る', '臉']
満員の電車の中 | ['満員', 'の', '電車', 'の', '中']
まるで誰かの | ['まるで', '誰', 'か', 'の']
人生のエキストラみたい | ['人生', 'の', 'エキストラ', 'みたい']
ただ欲しかったのは今を生きる理由 | ['ただ', '欲しい', 'た', 'の', 'は', '今', 'を', '生きる', '理由']
イメージしてた未来に | ['イメージ', 'する', 'てる', 'た', '未来', 'に']
どれだけ近づけただろう | ['どれ', 'だけ', '近づける', 'た', 'だ', 'う']
My life いつの日にかカラフル | ['M', 'y', 'life', 'いつ', 'の', '日', 'に', 'か', 'カラフル']
色のない 雨がいつか | ['色', 'の', 'ない', '雨', 'が', 'いつか']

None type
None type
178: 消えてしまいそうです | ZUTOMAYO
助けたい表面 寂しさが少年 | ['助ける', 'たい', '表面', '寂しい', 'さ', 'が', '少年']
始めからここに浸ってしまうから | ['始め', 'から', 'ここ', 'に', '浸る', 'て', 'しまう', 'から']
片手間だって わかったから | ['片手間', 'だって', 'わかる', 'た', 'から']
痒いもんね 体育座り本音 | ['痒い', 'もん', 'ね', '体育', '座り', '本音']
畳の香ばしい匂いが痛くする | ['畳', 'の', '香ばしい', '匂い', 'が', '痛い', 'する']
もう ひとけのない部屋 | ['もう', 'ひと', 'け', 'の', 'ない', '部屋']
スーパーの曲がり角 歩いた | ['スーパー', 'の', '曲がり角', '歩く', 'た']
秘密のはなし そんな帰り道が | ['秘密', 'の', 'はなし', 'そんな', '帰り道', 'が']
恋しくなってしまうから | ['恋しい', 'なる', 'て', 'しまう', 'から']
願うもんね 夢なんかじゃなくて | ['願う', 'もん', 'ね', '夢', 'なんか', 'じゃ', 'ない', 'て']
君の合図 歩き方で気づくよ | ['君', 'の', '合図', '歩く', '方', 'で', '気づく', 'よ']
もう ひとけのない部屋 | ['もう', 'ひと', 'け', 'の', 'ない', '部屋']
柔らかな緑はただ | ['柔らか', 'だ', '緑', 'は', 'ただ']
僕をやり直させようと必死で | ['僕', 'を', 'やり直す', 'せる', 'う', 'と', '必死', 'だ']
ままごとを続けた | ['ままごと', 'を', '続ける', 'た']
木を ねぇどうしたいんだ | ['木', 'を', 'ねぇ', 'どう', 'する', 'たい', 'ん', 'だ']
あゝ 今日が | ['あゝ', '今日', 'が']

179: 可愛くてごめん | HoneyWorks
私が私の事を愛して | ['私', 'が', '私', 'の', '事', 'を', '愛す', 'て']
何が悪いの？ 嫉妬でしょうか？ | ['何', 'が', '悪い', 'の', '?', '嫉妬', 'です', 'う', 'か', '?']
痛いだとか変わってるとか | ['痛い', 'だ', 'とか', '変わる', 'てる', 'と', 'か']
届きませんね そのリプライ | ['届く', 'ます', 'ん', 'ね', 'その', 'リプライ']
大好きなお洋服 大好きなお化粧で | ['大好き', 'だ', 'お', '洋服', '大好き', 'だ', 'お', '化粧', 'で']
お決まりのハーフツイン巻いて | ['お決まり', 'の', 'ハーフ', 'ツイン', '巻く', 'て']
お出かけしよ 日傘持って ぼっちだって | ['お出かけ', 'する', '日傘', '持つ', 'て', 'ぼる', 'ちる', 'だって']
幸せだもん！ | ['幸せ', 'だ', 'もん', '!']
チュ！ 可愛くてごめん | ['チュ', '!', '可愛い', 'て', 'ごめん']
生まれてきちゃってごめん | ['生まれる', 'て', 'くる', 'ちゃう', 'て', 'ごめん']
チュ！ あざとくてごめん | ['チュ', '!', 'あざとい', 'て', 'ごめん']
気になっちゃうよね？ ごめん | ['気', 'に', 'なる', 'ちゃう', 'よ', 'ね', '?', 'ごめん']
チュ！ 可愛くてごめん | ['チュ', '!', '可愛い', 'て', 'ごめん']
努力しちゃっててごめん | ['努力', 'する', 'ちゃう', 'て', 'てる', 'ごめん']
チュ！ 尊くてごめん | ['チュ', '!', '尊い', 'て', 'ごめん']
女子力高くてごめん | ['女子', '力', '高い', 'て', 'ごめん']
ムカついちゃうよね？ ざまあ | ['ムカ', 'つい', 'ちゃう', 'よ', 'ね', '?', 'ざま', 'あ']

180: Buriki No Dance | Ado
ブリキノダンス | ['ブリキ', 'ノ', 'ダンス']
さあ 憐れんで 血統書 持ち寄って反教典 | ['さあ', '憐れむ', 'で', '血統', '書', '持ち寄る', 'て', '反', '教典']
沈んだ唱導 腹這い幻聴 | ['沈む', 'だ', '唱導', '腹這い', '幻聴']
謁見 席巻 妄信症 | ['謁見', '席巻', '妄信', '症']
踊れ酔え孕め アヴァターラ新大系 | ['踊れる', '酔える', '孕む', 'アヴァターラ', '新大', '系']
斜めの幻聴 錻力と宗教 | ['斜め', 'の', '幻聴', '錻力', 'と', '宗教']
ラル・ラリ・唱えろ生 | ['ラル・ラリ・', '唱える', '生']
まあ 逆らって新王都 くぐもった脳系統 | ['まあ', '逆らう', 'て', '新', '王', '都', 'くぐもる', 'た', '脳', '系統']
墓掘れ説法 釈迦釈迦善行 | ['墓', '掘れる', '説法', '釈迦', '釈迦', '善行']
六感・吶喊・竜胆・錠 | ['六', '感', '・', '吶喊', '・', '竜胆', '・', '錠']
どれどれ 震え 蔑さげすんで新体系 | ['どれ', 'どれ', '震え', '蔑', 'さげすむ', 'で', '新体', '系']
欺瞞の延長 詭弁の劣等 | ['欺瞞', 'の', '延長', '詭弁', 'の', '劣等']
ドグ・ラグ・叶えろ | ['ドグ・ラグ・', '叶える']
不気味な手 此処に在り | ['不気味', 'だ', '手', '此処', 'に', '在る']
理性の目 咽び泣き | ['理性', 'の', '目', '咽ぶ', '泣き']
踵返せ遠くに | ['踵', '返せる', '遠く', 'に']
偲ぶ君の瞳を | ['偲ぶ', '君', 'の', '瞳', 'を']
さあ 皆舞いな 空洞で | ['さあ', '皆', '舞う', 'な', '空洞', 'で']
サンスクリット求道系 抉り抜いた鼓動 | ['サンスクリット', '求道', '系', '抉る', '抜く', 'た', '鼓動']
咲かせ咲かせ | ['咲かせる', '咲かせる']
さあ 剽悍な双眸を エーカム そうさ 先頭に | ['さあ', '剽悍', 'だ', '双眸', 'を', 'エーカム', 'そう', 'さ', '先頭', 'に']
真っ赤に濡れた空 踵鳴らせ | ['真っ赤', 'に', '濡れる', 'た', '空', '踵', '鳴る', 'せる']

181: Bakamitai - Taxi Driver Edition | 桐生一馬(黒田崇矢)
馬鹿みたい 子供なのね | ['馬鹿', 'みたい', '子供', 'だ', 'の', 'ね']
夢を追って傷ついて | ['夢', 'を', '追って', '傷つく', 'て']
嘘が下手なくせに 笑えない笑顔みせた | ['嘘', 'が', '下手', 'だ', 'くせ', 'に', '笑える', 'ない', '笑顔', 'みせる', 'た']
I love youも ろくに言わない | ['I', 'love', 'you', 'も', 'ろくに', '言う', 'ない']
口下手でほんまに不器用 | ['口下手', 'で', 'ほんま', 'に', '不器用']
なのになのにどうして サヨナラは言えたの | ['なのに', 'なのに', 'どうして', 'サヨナラ', 'は', '言える', 'た', 'の']
だめだね だめよ だめなのよ | ['だめ', 'だ', 'ね', 'だめ', 'よ', 'だめ', 'だ', 'の', 'よ']
あんたが 好きで好きすぎて | ['あんた', 'が', '好き', 'だ', '好く', 'すぎる', 'て']
どれだけ 強いお酒でも | ['どれ', 'だけ', '強い', 'お', '酒', 'で', 'も']
歪まない思い出が 馬鹿みたい | ['歪む', 'ない', '思い出', 'が', '馬鹿', 'みたい']

182: Bad Apple!! feat.nomico | nomico
流れてく時の中ででも 気だるさが | ['流れる', 'て', 'く', '時', 'の', '中', 'で', 'でも', '気だるい', 'さ', 'が']
ほらグルグル廻って | ['ほら', 'グルグル', '廻る', 'て']
私から 離れる心も | ['私', 'から', '離れる', '心', 'も']
見えないわ そう知らない | ['見える', 'ない', 'わ', 'そう', '知る', 'ない']
自分から 動くこともなく | ['自分', 'から', '動く', 'こと', 'も', 'ない']
時の隙間に 流され続けて | ['時', 'の', '隙間', 'に', '流す', 'れる', '続ける', 'て']
知らないわ 周りのことなど | ['知る', 'ない', 'わ', '周り', 'の', 'こと', 'など']
私は私 それだけ | ['私', 'は', '私', 'それだけ']
夢 見てる なにも見てない | ['夢', '見る', 'てる', 'なに', 'も', '見る', 'てる', 'ない']
語るも無駄な 自分の言葉 | ['語る', 'も', '無駄', 'だ', '自分', 'の', '言葉']
悲しむなんて 疲れるだけよ | ['悲しむ', 'なんて', '疲れる', 'だけ', 'よ']
何も感じず 過ごせばいいの | ['何', 'も', '感じる', 'ぬ', '過ごす', 'ば', 'いい', 'の']
戸惑う言葉 与えられても | ['戸惑う', '言葉', '与える', 'られる', 'て', 'も']
自分の心 ただ上の空 | ['自分', 'の', '心', 'ただ', '上の空']
もし 私から 動くのならば | ['もし', '私', 'から', '動く', 'の', 'だ', 'ば']
すべて変えるのなら 黒にする | ['すべて', '変える', 'の', 'だ', '黒', 'に', 'する']
こんな自分に 未来はあるの？ | ['こんな', '自分', 'に', '未来', 'は', 'ある', 'の', '?']
こんな世界に 私はいるの？ | ['こんな', '世界', 'に', '私', 'は', 'いる', 'の', '?']
今切ないの？ 今 悲しいの | ['今', '切ない', 'の', '?', '今', '悲しい', 'の']
自分の事も わからないまま | ['自分', 'の', '事', 'も', 'わかる', 'ない', 'まま']
歩むことさえ 疲れるだけよ | ['歩む', 'こと', 'さえ', '疲れる', 'だけ', 'よ']

None type
184: Bling-Bang-Bang-Born | Creepy Nuts
(Yeah, born) | ['(', 'Yeah', ',', 'born', ')']
チート gifted 荒技 wanted | ['チート', 'gifted', '荒', '技', 'wanted']
禁忌 禁じ手 明らか盲点 | ['禁忌', '禁じる', '手', '明らか', '盲点']
反則 異次元 この世のもんではないです | ['反則', '異', '次元', 'この世', 'の', 'もん', 'だ', 'は', 'ない', 'です']
無理ゲー それ聞いてないって | ['無理', 'ゲー', 'それ', '聞く', 'てる', 'ない', 'って']
Ayy ライバル口を揃えて | ['Ayy', 'ライバル', '口', 'を', '揃える', 'て']
Ooh ライバル口を揃えて | ['Ooh', 'ライバル', '口', 'を', '揃える', 'て']
バグで まぐれ 認めねーゼッテー | ['バグ', 'で', 'まぐれ', '認める', 'ぬ', 'ーゼッテー']
マジで？ コレおま全部生身で？ | ['マジ', 'だ', '?', 'コレ', 'お', 'ま', '全部', '生身', 'で', '?']
It's 生身 it's 生身 yeah, yeah, yeah, yeah | ['It', "'", 's', '生身', 'it', "'", 's', '生身', 'yeah', ',', 'yeah', ',', 'yeah', ',', 'yeah']
Bling-bang-bang, bling-bang-bang-born | ['Bling', '-', 'bang', '-', 'bang', ',', 'bling', '-', 'bang', '-', 'bang', '-', 'born']
Bling-bang-bang, bling-bang-bang-born | ['Bling', '-', 'bang', '-', 'bang', ',', 'bling', '-', 'bang', '-', 'bang', '-', 'born']
実力を発揮し切る前に | ['実力', 'を', '発揮', 'する', '切る', '前', 'に']
相手の方がバックれてくらしい | ['相手', 'の', '方', 'が', 'バック', 'れる', 'て', 'く', 'らしい']
上がり切るハードルvery happy | ['上がる', '切る', 'ハードル', 'very', 'happy']
あきらかにダントツでピカイチ | ['あきらか', 'に', 'ダントツ', 'で', 'ピカ', 'イチ']
相変わらず脱皮してる毎日 (bling, bling, bling) | ['相変わらず', '脱皮', 'する', 'てる', '毎日', '(', 'bling', ',', 'bling', ',', 'bling', ')']
誰の七光も要らないお前のice よりicy (icy) | ['誰', 'の', '七光', 'も', '要る', 'ない', 'お前', 'の', 'ice', 'より', 'icy', '(', 'icy', ')']
俺 パッと見出来ない事ばっかりだけどvery happy | ['俺', 'パッ', 'と', '見る', '出来る', 'ない', '事', 'ばっかり', 'だ', 'けど', 'very', 'happy']
あ キレてる呆れてる周り 恵まれてる家族友達 (happy) | ['あ', 'キレ', 'てる', '呆れる', 'てる', '周り', '恵まれる', 'てる', '家族', '友達', '(', 'happy', ')']
もう反則的立ち位置 皆俺に任せとけば良い (bang, bang, bang) | ['もう', '反則', '的', '立ち', '位置', '皆', '俺', 'に', '任せる', 'とく', 'ば', '良い', '(', 'bang', ',', 'bang', ',', 'bang', ')']
教科書に無い 問題集に無い 超badな呪 (listen) | ['教科書', 'に', '無い', '問題', '集', 'に', '無い', '超', 'bad', 'だ', '呪', '(', 'listen', ')']

185: アイウエ | MAISONdes
（ア・ア・オーエオ・ア・エ・ア・エ・オー） | ['(', 'ア・ア・オーエオ・ア・エ・ア・エ・オー', ')']
（ア・ア・オーエオ・ア・エ・ア・エ・オー） | ['(', 'ア・ア・オーエオ・ア・エ・ア・エ・オー', ')']
（ア・ア・オーエオ・ア・エ・ア・エ・オー） | ['(', 'ア・ア・オーエオ・ア・エ・ア・エ・オー', ')']
（ア・ア・オーエオ・ア・エ・ア・エ・オー） | ['(', 'ア・ア・オーエオ・ア・エ・ア・エ・オー', ')']
ねぇ その 君はさ 私に ちょっと興味ないの？ | ['ねぇ', 'その', '君', 'は', 'さ', '私', 'に', 'ちょっと', '興味', 'ない', 'の', '?']
あぁ そう じゃあ いいから | ['あぁ', 'そう', 'じゃあ', 'いい', 'から']
忘れて いや やっぱ 忘れないで | ['忘れる', 'て', 'いや', 'やっぱ', '忘れる', 'ない', 'で']
あぁ もう どうして こんなに君推しなのに | ['あぁ', 'もう', 'どうして', 'こんなに', '君', '推す', 'だ', 'のに']
気づかれない ほんともどかしいわ！ | ['気づく', 'れる', 'ない', 'ほんと', 'もどかしい', 'わ', '!']
え そんな | ['え', 'そんな']
聞いてないって 知らないって | ['聞く', 'てる', 'ない', 'って', '知る', 'ない', 'って']
私 全部全部をわかっていたいの | ['私', '全部', '全部', 'を', 'わかる', 'て', 'いる', 'たい', 'の']
ダメだよって？ そんなこと言われても | ['ダメ', 'だ', 'よ', 'って', '?', 'そんな', 'こと', '言う', 'れる', 'て', 'も']
意味わかんないじゃん！ | ['意味', 'わかる', 'ない', 'じゃん', '!']
「不可解現象」「異常上昇」 | ['「', '不可解', '現象', '」', '「', '異常', '上昇', '」']
「どこがいいの？」なんて よく聞かれるけどさ | ['「', 'どこ', 'が', 'いい', 'の', '?', '」', 'なんて', 'よく', '聞く', 'れる', 'けど', 'さ']
わからないでいいよ | ['わかる', 'ない', 'だ', 'いい', 'よ']
愛で 溢れて溢れてああ触れて止まらないだけ | ['愛でる', '溢れる', 'て', '溢れる', 'て', 'ああ', '触れる', 'て', '止まる', 'ない', 'だけ']
（ア・ア・オーエオ・ア・エ・ア・エ・オー） | ['(', 'ア・ア・オーエオ・ア・エ・ア・エ・オー', ')']
あー！つまらないド星論 | ['あー', '!', 'つまらない', 'ド', '星', '論']
飽きない超恋愛論 | ['飽きる', 'ない', '超', '恋愛', '論']
さあ、どうする？ダーリン？ねえ？(鳴！呼！愛飢え) | ['さあ', '、', 'どう', 'する', '?', 'ダーリン', '?', 'ねえ', '?', '(', '鳴る', '!', '呼', '!', '愛', '飢え', ')']
ああ もう 君はさ | ['ああ', 'もう', '君', 'は', 'さ']
僕に愛飢えちゃってしょうがない | ['僕', 'に', '愛', '飢える', 'ちゃう', 'て', 'しょうが', 'ない']
いつも抜き足差し足するのは忍びないけど | ['いつも', '抜き足', '差し', '足', 'する', 'の', 'は', '忍び', 'ない', 'けど']

186: No title | Reol
ずっと夢見てた僕になれたかな | ['ずっと', '夢見る', 'てる', 'た', '僕', 'に', 'なれる', 'た', 'か', 'な']
とうに帰れないとこまで来たみたい | ['とうに', '帰れる', 'ない', 'とこ', 'まで', '来る', 'た', 'みたい']
自分の足で二段飛ばしてそうもっと先へ | ['自分', 'の', '足', 'で', '二', '段', '飛ばす', 'て', 'そう', 'もっと', '先', 'へ']
駆けていけるはずだからran away | ['駆ける', 'て', 'いける', 'はず', 'だ', 'から', 'ran', 'away']
深くなる傷を縫い付け | ['深い', 'なる', '傷', 'を', '縫う', '付け']
繋ぐパス軸に廻りだす | ['繋ぐ', 'パス', '軸', 'に', '廻る', 'だす']
慣れた痛み、焦る呼吸とビート | ['慣れる', 'た', '痛み', '、', '焦る', '呼吸', 'と', 'ビート']
気付かないふりしてまた一人 | ['気付く', 'ない', 'ふり', 'する', 'て', 'また', '一', '人']
何が正当？ないな永劫 | ['何', 'が', '正当', '?', 'ない', 'な', '永劫']
誰が間違った対価払うの | ['誰', 'が', '間違う', 'た', '対価', '払う', 'の']
あんたが嫌いなあいつはきっと | ['あんた', 'が', '嫌い', 'だ', 'あいつ', 'は', 'きっと']
ただ「それだけ」で不正解なんだ | ['ただ', '「', 'それだけ', '」', 'で', '不', '正解', 'だ', 'ん', 'だ']
０点だって提言したって | ['0', '点', 'だって', '提言', 'する', 'た', 'って']
全然納得できない理由も | ['全然', '納得', 'できる', 'ない', '理由', 'も']
最前線はいつだってここだった | ['最前線', 'は', 'いつ', 'だって', 'ここ', 'だ', 'た']
最善策は最初からなかった | ['最善', '策', 'は', '最初', 'から', 'ない', 'た']
緩やかに崩れ壊れてく | ['緩やか', 'に', '崩れる', '壊れる', 'て', 'く']
ゆるりゆるり首を締めるように | ['ゆるり', 'ゆるり', '首', 'を', '締める', 'よう', 'に']
昨日までの僕が殺されていく | ['昨日', 'まで', 'の', '僕', 'が', '殺す', 'れる', 'て', 'いく']
緩やかに離れ離れ飽く | ['緩やか', 'に', '離れ離れ', '飽く']
ぐらりんり君にきこえるのは | ['ぐらり', 'ん', 'り', '君', 'に', 'きこえる', 'の', 'は']
僕が知らない声になってく | ['僕', 'が', '知る', 'ない', '声', 'に', 'なる', 'て', 'く']

187: COLORS | FLOW
自分を 世界さえも 変えてしまえそうな | ['自分', 'を', '世界', 'さえ', 'も', '変える', 'て', 'しまう', 'そう', 'な']
瞬間は いつもすぐそばに... | ['瞬間', 'は', 'いつも', 'すぐ', 'そば', 'に', '.', '.', '.']
隠せぬ苛立ちと 立ち尽くす自分を 見つめ | ['隠せる', 'ぬ', '苛立つ', 'と', '立ち尽くす', '自分', 'を', '見つめる']
迷いながら 悩みながら | ['迷う', 'ながら', '悩む', 'ながら']
悔やみながら 決めればいいさ | ['悔やむ', 'ながら', '決める', 'ば', 'いい', 'さ']
君がくれた 言葉ひとつ 戸惑いは消え去り | ['君', 'が', 'くれる', 'た', '言葉', 'ひとつ', '戸惑い', 'は', '消え去る']
からっぽだった 僕の部屋に 光が射した | ['からっぽ', 'だ', 'た', '僕', 'の', '部屋', 'に', '光', 'が', '射す', 'た']

188: 名前のない怪物 | EGOIST
フェアリーテイルはさっき死んだみたい | ['フェアリーテイル', 'は', 'さっき', '死ぬ', 'だ', 'みたい']
煉瓦の病棟でうまく歌えなくて | ['煉瓦', 'の', '病棟', 'で', 'うまい', '歌える', 'ない', 'て']
霧に煙る夜 浮かべ赤い月 | ['霧', 'に', '煙る', '夜', '浮かべる', '赤い', '月']
ほらみて 私を | ['ほら', 'みる', 'て', '私', 'を']
目を逸らさないで | ['目', 'を', '逸らす', 'ない', 'で']
黒い鉄格子の中で | ['黒い', '鉄格子', 'の', '中', 'で']
私は生まれてきたんだ | ['私', 'は', '生まれる', 'て', 'くる', 'た', 'ん', 'だ']
悪意の代償を願え | ['悪意', 'の', '代償', 'を', '願う']
望むがままにお前に | ['望', 'むがままにお', '前', 'に']
さあ与えよう正義を | ['さあ', '与える', 'う', '正義', 'を']
壊して 壊される前に | ['壊す', 'て', '壊す', 'れる', '前', 'に']
因果の代償を払い | ['因果', 'の', '代償', 'を', '払う']
共に行こう 名前のない怪物 | ['共に', '行く', 'う', '名前', 'の', 'ない', '怪物']
耳鳴りがしてる | ['耳鳴り', 'が', 'する', 'てる']
鉄条網うるさくって | ['鉄条', '網', 'うるさい', 'て']

189: 綺羅キラー | ZUTOMAYO
周りに合わせる言語も知らねえ | ['周り', 'に', '合わせる', '言語', 'も', '知る', 'ない']
守備力は弱いけど勘は鋭 | ['守備', '力', 'は', '弱い', 'けど', '勘', 'は', '鋭い']
一旦進められたら止まれ | ['一旦', '進める', 'られる', 'た', '止まる']
いったん木綿みたいに | ['いったん', '木綿', 'みたい', 'に']
曲がれまだ上 ゆらゆら揺らして | ['曲がれる', 'まだ', '上', 'ゆらゆら', '揺らす', 'て']
すぐとらぶるぜ 過呼吸(ブレス)と心得 | ['す', 'ぐとらぶるぜ', '過', '呼吸', '(', 'ブレス', ')', 'と', '心得']
って原罪人生 盾と矛で 葛藤の活動がマスト | ['って', '原罪', '人生', '盾', 'と', '矛', 'で', '葛藤', 'の', '活動', 'が', 'マスト']
締め切られなきゃ言葉が増殖 | ['締め切る', 'れる', 'ない', '言葉', 'が', '増殖']
No thoughts, head empty 虚無で円陣 | ['No', 'thoughts', ',', 'head', 'empty', '虚無', 'で', '円陣']
Brought to you in chaos and serenity | ['Brought', 't', 'o', 'you', 'in', 'chaos', 'and', 'serenity']
やめたいことをやらなきゃ満たされない僕 | ['やめる', 'たい', 'こと', 'を', 'やる', 'ない', '満たす', 'れる', 'ない', '僕']
Shockin', isn't it? | ['Shockin', "',", 'isn', "'", 't', 'it', '?']
"Dream life?" You're livin' it | ['"', 'Dream', 'life', '?"', 'You', "'", 'r', 'e', 'livin', "'", 'i', 't']
"バイトだったらどこでもよくない？" | ['"', 'バイト', 'だ', 'た', 'どこ', 'でも', 'よい', 'ない', '?', '"']
綺羅キラー | ['綺羅', 'キラー']
嫌いなんて序の口 そう思うと楽だし | ['嫌い', 'なんて', '序の口', 'そう', '思う', 'と', '楽', 'だ', 'し']
Three, two, oneで歪み合った | ['Three', ',', 'two', ',', 'one', 'で', '歪む', '合う', 'た']
君のその口 シガレット辛口 | ['君', 'の', 'その', '口', 'シガレット', '辛口']
割り切ったけど | ['割り切る', 'た', 'けど']
(知るか? 汁なら drink up we're still tough) | ['(', '知る', 'か', '?', '汁', 'だ', 'drink', 'u', 'p', 'w', 'e', "'", 'r', 'e', 'still', 'tough', ')']
最低なコンプだし 最高の昆布だし | ['最低', 'だ', 'コンプ', 'だ', 'し', '最高', 'の', '昆布', 'だ', 'し']
揃ってるだけじゃつまらんし | ['揃う', 'てる', 'だけ', 'じゃ', 'つまる', 'ん', 'し']
繋いだって綻ぶし しょっぱいな鰹節 | ['繋ぐ', 'だって', '綻ぶ', 'し', 'しょっぱい', 'な', '鰹節']
もっと甘えたいけど？ | ['もっと', '甘える', 'たい', 'けど', '?']
ぞんざいでアップダウンな現状が今ヒット中 | ['ぞんざい', 'だ', 'アップダウン', 'だ', '現状', 'が', '今', 'ヒット', '中']

190: My Dearest | supercell
So, everything that makes me whole | ['So', ',', 'everything', 'that', 'makes', 'm', 'e', 'whole']
今君に捧げよう | ['今', '君', 'に', '捧げる', 'う']
I'm Yours | ['I', "'", 'm', 'Yours']
ねえ こんなに笑えたこと | ['ねえ', 'こんなに', '笑える', 'た', 'こと']
生まれて初めてだよ | ['生まれる', 'て', '初めて', 'だ', 'よ']
きっと私はね | ['きっと', '私', 'は', 'ね']
この日の為に間違いだらけの | ['この', '日', 'の', '為', 'に', '間違い', 'だらけ', 'の']
道を歩いてきたんだ | ['道', 'を', '歩く', 'て', 'くる', 'た', 'ん', 'だ']
ずっと一人で | ['ずっと', '一', '人', 'だ']
遠く遠くどこまでも遠く | ['遠く', '遠い', 'どこ', 'まで', 'も', '遠い']
君と二人 手を取って永遠に | ['君', 'と', '二', '人', '手', 'を', '取る', 'て', '永遠', 'に']
どこまでだって行けるはず | ['どこ', 'まで', 'だって', '行ける', 'はず']
もう一人じゃないと君はそう言い | ['もう', '一', '人', 'じゃ', 'ない', 'と', '君', 'は', 'そう', '言う']
また笑う | ['また', '笑う']

None type
192: Rhapsody of Blue Sky | fhána
Chu-chu, yeah! | ['Chu', '-', 'chu', ',', 'yeah', '!']
Please me! | ['Please', 'm', 'e', '!']
Chu-chu yeah! | ['Chu', '-', 'chu', 'yeah', '!']
Without you! | ['Without', 'you', '!']
あー！ なんてことだ 些細な過ちだ | ['あー', '!', 'なんて', 'こと', 'だ', '些細', 'だ', '過ち', 'だ']
自分のことに タララッタラッタ 手焼く | ['自分', 'の', 'こと', 'に', 'タララッタラッタ', '手', '焼く']
どうして突然？ 逃げ切ったっていいでしょ？ | ['どうして', '突然', '?', '逃げ切る', 'たって', 'いい', 'です', '?']
だけど なんだか気まぐれモードになり | ['だけど', 'なんだか', '気まぐれ', 'モード', 'に', 'なる']
そんな気分になっちゃって | ['そんな', '気分', 'に', 'なる', 'ちゃう', 'て']
始まりはそんな風で | ['始まり', 'は', 'そんな', '風', 'で']
つまりはらしくないようで | ['つまり', 'は', 'らしい', 'ない', 'よう', 'だ']
でも今じゃ扉開けてほら | ['でも', '今', 'じゃ', '扉', '開ける', 'て', 'ほら']
声が聴こえるよ さあ！行こう！ | ['声', 'が', '聴こえる', 'よ', 'さあ', '!', '行く', 'う', '!']
どこへでも | ['どこ', 'へ', 'で', 'も']
僕は君の翼になれる勇気があるよ | ['僕', 'は', '君', 'の', '翼', 'に', 'なれる', '勇気', 'が', 'ある', 'よ']
どんな試練も怖くない その魔法があるから | ['どんな', '試練', 'も', '怖い', 'ない', 'その', '魔法', 'が', 'ある', 'から']
初めて出会う世界に 花束を贈ろう | ['初めて', '出会う', '世界', 'に', '花束', 'を', '贈る', 'う']
ただこの瞬間結ばれるよ | ['ただ', 'この', '瞬間', '結ぶ', 'れる', 'よ']
ちぐはぐなコミュニケーション？ | ['ちぐはぐ', 'だ', 'コミュニケーション', '?']
でも別に構わない | ['でも', '別', 'に', '構う', 'ない']
明日から平和なら | ['明日', 'から', '平和', 'だ']

193: Don't Say "Lazy" (From "K-On!") | Sakurakou K-ON Bu
Please don't say "You are lazy" | ['Please', 'don', "'", 't', 'say', '"', 'You', 'are', 'lazy', '"']
だって本当はcrazy | ['だって', '本当は', 'crazy']
白鳥たちはそう | ['白鳥', 'たち', 'は', 'そう']
見えないとこでバタ足するんです | ['見える', 'ない', 'とこ', 'で', 'バタ', '足', 'する', 'ん', 'です']
本能に従順 忠実 翻弄も重々承知 | ['本能', 'に', '従順', '忠実', '翻弄', 'も', '重々', '承知']
前途洋々だし... | ['前途', '洋々', 'だ', 'し', '.', '.', '.']
だからたまに休憩しちゃうんです | ['だから', 'たまに', '休憩', 'する', 'ちゃう', 'ん', 'です']
この目でしっかり見定めて | ['この', '目', 'で', 'しっかり', '見定める', 'て']
行き先地図上マークして | ['行き先', '地図', '上', 'マーク', 'する', 'て']
近道あればそれが王道 | ['近道', 'ある', 'ば', 'それ', 'が', '王道']
はしょれる翼もあれば上等 | ['はしょれる', '翼', 'も', 'ある', 'ば', '上等']
ヤバ 爪割れた グルーで補修した | ['ヤバ', '爪', '割れる', 'た', 'グルー', 'で', '補修', 'する', 'た']
それだけでなんか達成感 | ['それ', 'だけ', 'だ', 'なんか', '達成', '感']
大事なのは自分 かわいがること | ['大事', 'だ', 'の', 'は', '自分', 'かわいがる', 'こと']
自分を愛さなきゃ 他人も愛せない | ['自分', 'を', '愛す', 'ない', '他人', 'も', '愛せる', 'ない']

194: 嘘 | SID
あの日見た空 茜色の空を | ['あの', '日', '見る', 'た', '空', '茜色', 'の', '空', 'を']
ねぇ 君は覚えていますか | ['ねぇ', '君', 'は', '覚える', 'て', 'いる', 'ます', 'か']
約束 契り 初夏の風が包む | ['約束', '契り', '初夏', 'の', '風', 'が', '包む']
二人 寄り添った | ['二', '人', '寄り添う', 'た']
無理な笑顔の裏 伸びた影を匿う | ['無理', 'だ', '笑顔', 'の', '裏', '伸びる', 'た', '影', 'を', '匿う']
だから気づかぬように再生を選ぶ | ['だから', '気づく', 'ぬ', 'よう', 'に', '再生', 'を', '選ぶ']
テーブルの上の 震えない知らせ 待ち続けて | ['テーブル', 'の', '上', 'の', '震える', 'ない', '知らせ', '待つ', '続ける', 'て']
空白の夜も 来るはずのない朝も | ['空白', 'の', '夜', 'も', '来る', 'はず', 'の', 'ない', '朝', 'も']
全部わかってたんだ | ['全部', 'わかる', 'てる', 'た', 'ん', 'だ']

195: 絶体絶命 | Cö shu Nie
朱らむ空が 今日はこんなに怖い | ['朱', 'ら', 'む', '空', 'が', '今日', 'は', 'こんなに', '怖い']
知らなければ 幸せでいられた? | ['知る', 'ない', 'ば', '幸せ', 'だ', 'いる', 'られる', 'た', '?']
暖かい灯火一つまた落ちる | ['暖かい', '灯火', '一つ', 'また', '落ちる']
こうやって知らぬ間に失っていた | ['こう', 'やる', 'て', '知る', 'ぬ', '間', 'に', '失う', 'て', 'いる', 'た']
あの優しい声 信じてしまったの | ['あの', '優しい', '声', '信じる', 'て', 'しまう', 'た', 'の']
僕にはそれだけだった | ['僕', 'に', 'は', 'それだけ', 'だ', 'た']
心失くせば楽になれるなんて | ['心', '失', 'くせ', 'ば', '楽', 'に', 'なれる', 'なんて']

196: アメヲマツ、 | 美波
過去形フィルムに縋った僕らは | ['過去', '形', 'フィルム', 'に', '縋る', 'た', '僕ら', 'は']
舵取り粘土に飲まれていつしか固まっていくようで | ['舵取り', '粘土', 'に', '飲む', 'れる', 'て', 'いつしか', '固まる', 'て', 'いく', 'よう', 'だ']
言葉税が 足りなくなっていってさ | ['言葉', '税', 'が', '足りる', 'ない', 'なる', 'て', 'いく', 'て', 'さ']
書きなぐり漁った下書きをそっと強く塗りつぶす | ['書きなぐる', '漁る', 'た', '下書き', 'を', 'そっと', '強い', '塗りつぶす']
平気だよきっと誰かが 透明人間あてにした | ['平気', 'だ', 'よ', 'きっと', '誰', 'か', 'が', '透明', '人間', 'あて', 'に', 'する', 'た']
ああやっぱ今日もだめだな | ['ああ', 'やっぱ', '今日', 'も', 'だめ', 'だ', 'な']
ファインダー越しのかわききってた | ['ファインダー', '越し', 'の', 'かわき', 'きる', 'てる', 'た']
僕にアメ降らせてくれないか | ['僕', 'に', 'アメ', '降る', 'せる', 'て', 'くれる', 'ない', 'か']
何度塗り替えても 濁ってしまって | ['何', '度', '塗り替える', 'て', 'も', '濁る', 'て', 'しまう', 'て']
今はもう届かなくなったリリック | ['今', 'は', 'もう', '届く', 'ない', 'なる', 'た', 'リリック']
曖昧な言葉捻り出しては | ['曖昧', 'だ', '言葉', '捻り出す', 'て', 'は']
固まりかけながらまだ足りないと | ['固まる', 'かける', 'ながら', 'まだ', '足りる', 'ない', 'と']
なんて本当 虚しくなってしまったのでしょう | ['なんて', '本当', '虚しい', 'なる', 'て', 'しまう', 'た', 'の', 'です', 'う']
普遍化には見向きもしないようだ | ['普遍', '化', 'に', 'は', '見向く', 'も', 'する', 'ない', 'よう', 'だ']
雨に 交えないでいて | ['雨', 'に', '交える', 'ない', 'で', 'いる', 'て']
使いすぎってしまったエキを | ['使う', 'すぎる', 'く', 'て', 'しまう', 'た', 'エキ', 'を']

197: suima | KANKAN
さっきからうるさい | ['さっき', 'から', 'うるさい']
窓閉めて | ['窓', '閉める', 'て']
まだ眠らせて | ['まだ', '眠らせる', 'て']
独り言は枕元に落ちたまま | ['独り言', 'は', '枕元', 'に', '落ちる', 'た', 'まま']
邪魔臭い | ['邪魔', '臭い']
寝返りを打つペースが上がった | ['寝返り', 'を', '打つ', 'ペース', 'が', '上がる', 'た']
腕が痺れて起きることもない | ['腕', 'が', '痺れる', 'て', '起きる', 'こと', 'も', 'ない']
いつまでも夢の中にいられる | ['いつ', 'まで', 'も', '夢', 'の', '中', 'に', 'いる', 'られる']
ねえ早く起こしてよ | ['ねえ', '早い', '起こす', 'て', 'よ']
退屈なんだ | ['退屈', 'だ', 'ん', 'だ']
君がいないとさ | ['君', 'が', 'いる', 'ない', 'と', 'さ']
味気なく過ぎていく日々 | ['味気', 'ない', '過ぎる', 'て', 'いく', '日々']
思い出したのは | ['思い出す', 'た', 'の', 'は']
あの日の溜め息 | ['あの', '日', 'の', '溜め息']
見ないフリしていたのは | ['見る', 'ない', 'フリ', 'する', 'て', 'いる', 'た', 'の', 'は']
怖かったからさ | ['怖い', 'た', 'から', 'さ']
さっきからうるさい | ['さっき', 'から', 'うるさい']
窓閉めて | ['窓', '閉める', 'て']

198: BLOODY STREAM | Coda
静寂の底から 目覚めるその柱たち 時を越え | ['静寂', 'の', '底', 'から', '目覚める', 'その', '柱', 'たち', '時', 'を', '越える']
深紅の血潮が 立ち上がる勇気を 惹きあわせる | ['深紅', 'の', '血潮', 'が', '立ち上がる', '勇気', 'を', '惹く', 'あう', 'せる']
受け継ぐ愛を 宿命と呼ぶなら | ['受け継ぐ', '愛', 'を', '宿命', 'と', '呼ぶ', 'だ']
微笑む目で 次の手を | ['微笑む', '目', 'で', '次', 'の', '手', 'を']
闇を欺いて 刹那を躱して | ['闇', 'を', '欺く', 'て', '刹那', 'を', '躱す', 'て']
刃すり抜け奴らの間隙を突け | ['刃', 'すり抜ける', '奴ら', 'の', '間隙', 'を', '突ける']
つらぬいた信念が 未来を拓く | ['つらぬく', 'た', '信念', 'が', '未来', 'を', '拓く']
Like a bloody storm 熱くlike a bloody stone | ['Like', 'a', 'bloody', 'storm', '熱い', 'like', 'a', 'bloody', 'stone']
血脈に刻まれた因縁に | ['血脈', 'に', '刻む', 'れる', 'た', '因縁', 'に']

199: ハルシネイト | LiSA
チウニング狂わされて | ['チウニング', '狂わす', 'れる', 'て']
全身に違和が残る | ['全身', 'に', '違和', 'が', '残る']
十年前のモワトリックの衝撃は | ['十', '年', '前', 'の', 'モワトリック', 'の', '衝撃', 'は']
今や鼓膜を撃つ気配すらない | ['今や', '鼓膜', 'を', '撃つ', '気配', 'すら', 'ない']
自らの欲望と喪失も | ['自ら', 'の', '欲望', 'と', '喪失', 'も']
また同じように壊れてゆくのだ | ['また', '同じ', 'よう', 'に', '壊れる', 'て', 'ゆく', 'の', 'だ']
眼球を逸らさないで | ['眼球', 'を', '逸らす', 'ない', 'で']
現実に耳を澄ませ | ['現実', 'に', '耳', 'を', '澄む', 'せる']
全人類がシステマチックに則って | ['全', '人類', 'が', 'システマチック', 'に', '則る', 'て']
美学が科学に慄いているのだ | ['美学', 'が', '科学', 'に', '慄', 'いる', 'て', 'いる', 'の', 'だ']
正しさが戸を塞ぐ密室で | ['正しい', 'さ', 'が', '戸', 'を', '塞ぐ', '密室', 'で']
四壁を爆破する芸術をずっと | ['四壁', 'を', '爆破', 'する', '芸術', 'を', 'ずっと']
膝を抱えて待っている | ['膝', 'を', '抱える', 'て', '待つ', 'て', 'いる']
何か足りない 何が足りない | ['何', 'か', '足りる', 'ない', '何', 'が', '足りる', 'ない']
答は剥き出しの本能 | ['答', 'は', '剥き出し', 'の', '本能']

